year,cod_dpto,alive,fetal,no_fetal,deaths,Total,fetal_percapita,no_fetal_percapita,alive_percapita,deaths_percapita,DPNOM,Total pregnan,prob_alive,prob_fetal,prob_no_fetal
2008,05,90490,5317,1199,6516,5783831,0.09192868878776023,0.02073020459968488,1.564533956818586,0.1126588933874451,Antioquia,97006,0.9328288971816177,0.054811042615920666,0.012360060202461703
2009,05,85458,4395,976,5371,5843258,0.07521488868025338,0.016703010546513606,1.4625060197581554,0.09191789922676699,Antioquia,90829,0.9408669037421968,0.0483876295015909,0.010745466756212223
2010,05,77951,4517,859,5376,5902729,0.0765239264753642,0.01455259084399775,1.3205925598142825,0.09107651731936195,Antioquia,83327,0.9354830967153503,0.0542081198171061,0.010308783467543534
2011,05,76361,5108,818,5926,5959950,0.08570541699175328,0.013724947356940914,1.2812355808354097,0.0994303643486942,Antioquia,82287,0.9279837641425741,0.06207541896046763,0.009940816896958207
2012,05,77139,6063,764,6827,6013862,0.10081707894195112,0.012703982898177577,1.2826865664692673,0.1135210618401287,Antioquia,83966,0.9186932806135817,0.07220779839458828,0.009098920991830026
2013,05,74757,6148,742,6890,6066128,0.10134965829933032,0.012231855311988142,1.2323676651729076,0.11358151361131845,Antioquia,81647,0.9156123311328034,0.07529976606611388,0.009087902801082709
2014,05,76419,6103,733,6836,6118257,0.09975063159327893,0.01198053628672349,1.24903219985692,0.11173116788000242,Antioquia,83255,0.9178908173683262,0.07330490661221548,0.00880427601945829
2015,05,75930,7109,666,7775,6172103,0.11517954253193766,0.010790487456220351,1.2302127816078248,0.125970029988158,Antioquia,83705,0.9071142703542202,0.08492921569798698,0.007956513947792844
2016,05,75024,7461,675,8136,6233144,0.11969882293750955,0.010829205935239103,1.2036301423487088,0.13052802887274864,Antioquia,83160,0.9021645021645022,0.08971861471861473,0.008116883116883116
2017,05,76844,6090,700,6790,6299264,0.09667796110783736,0.011112409322739927,1.219888545709467,0.10779037043057729,Antioquia,83634,0.9188129229739102,0.07281727527082286,0.008369801755266996
2008,08,41299,286,619,905,2240312,0.012766079010423549,0.02763008009598663,1.8434485910890983,0.04039615910641018,Atlántico,42204,0.9785565349255995,0.0067766088522414935,0.014666856222159037
2009,08,39797,317,578,895,2265864,0.013990248311460882,0.02550903319881511,1.756371962306652,0.03949928151027599,Atlántico,40692,0.9780055047675219,0.007790229037648678,0.014204266194829451
2010,08,35146,251,455,706,2290571,0.010957966376069548,0.019864042633910933,1.534377236069085,0.03082200900998048,Atlántico,35852,0.9803079326118487,0.007001004128082115,0.012691063260069173
2011,08,35042,290,513,803,2313848,0.012533234680929775,0.022170859970058535,1.5144469299625558,0.03470409465098831,Atlántico,35845,0.9775979913516529,0.008090389175617241,0.01431161947272981
2012,08,39873,515,484,999,2336111,0.022045185352922013,0.020718193613231562,1.7068110205379796,0.04276337896615358,Atlántico,40872,0.9755578391074574,0.012600313172832257,0.011841847719710315
2013,08,39054,560,553,1113,2357801,0.02375094420606319,0.023454057403487404,1.6563738839706998,0.047205001609550594,Atlántico,40167,0.9722906863843453,0.013941793014165857,0.013767520601488784
2014,08,41014,700,570,1270,2378534,0.02942989253044102,0.02396434106050197,1.7243394460621542,0.053394233590942995,Atlántico,42284,0.9699649985810236,0.01655472519156182,0.013480276227414625
2015,08,40621,577,568,1145,2400233,0.024039332848102665,0.023664369250818565,1.6923773650308116,0.04770370209892123,Atlántico,41766,0.9725853565100799,0.013815064885313413,0.013599578604606618
2016,08,40880,1458,531,1989,2429224,0.06001916661452381,0.02185883228553645,1.6828419281219023,0.08187799890006027,Atlántico,42869,0.9536028365485549,0.034010590403321744,0.012386573048123352
2017,08,42135,1690,529,2219,2464294,0.06857947955885134,0.021466594489131574,1.7098203379953854,0.09004607404798291,Atlántico,44354,0.9499706903548721,0.03810253866618569,0.011926770978942148
2008,11,117590,7930,1558,9488,6936977,0.11431492420978187,0.022459350809437596,1.6951187815672446,0.13677427501921946,"Bogotá, D.C.",127078,0.9253371944789814,0.062402618864004784,0.012260186657013802
2009,11,115799,7473,1399,8872,7003434,0.1067047965326724,0.01997591467271627,1.6534602881957623,0.12668071120538868,"Bogotá, D.C.",124671,0.9288366981896351,0.05994176673003345,0.011221535080331432
2010,11,110947,8674,1316,9990,7065669,0.12276261455213937,0.018625271011138506,1.5702264003592583,0.14138788556327786,"Bogotá, D.C.",120937,0.9173950073178597,0.07172329394643492,0.010881698735705367
2011,11,107007,8980,1291,10271,7119281,0.1261363331493728,0.018133853685505602,1.5030590870061176,0.1442701868348784,"Bogotá, D.C.",117278,0.9124217670833404,0.07657020071965756,0.011008032197001996
2012,11,105451,10185,1248,11433,7162261,0.14220369796632656,0.017424665199997597,1.4723143990424252,0.15962836316632414,"Bogotá, D.C.",116884,0.9021850723794531,0.08713767495978919,0.010677252660757674
2013,11,103256,10296,1052,11348,7197326,0.14305312834238715,0.01461653953148711,1.4346439219232254,0.15766966787387426,"Bogotá, D.C.",114604,0.9009807685595617,0.08983979616767303,0.009179435272765348
2014,11,103856,9884,1049,10933,7226652,0.13677149529270263,0.014515712116758908,1.437124687891433,0.15128720740946153,"Bogotá, D.C.",114789,0.9047556821646674,0.08610581153246391,0.009138506302868742
2015,11,102795,10452,911,11363,7253823,0.1440895373377597,0.012558894806228385,1.4171148096665718,0.15664843214398808,"Bogotá, D.C.",114158,0.9004625168625939,0.09155731529984758,0.007980167837558472
2016,11,98653,8820,928,9748,7290415,0.12098076721284041,0.012729042173868017,1.3531877129079757,0.13370980938670843,"Bogotá, D.C.",108401,0.9100746303078385,0.08136456305753637,0.008560806634625141
2017,11,92054,7662,866,8528,7333415,0.10448065464725506,0.011808959400224861,1.2552678390627015,0.11628961404747992,"Bogotá, D.C.",100582,0.9152134576763238,0.07617665188602335,0.00860989043765286
2008,13,30801,378,512,890,1876733,0.020141383990157365,0.02728145133058352,1.6412030906900448,0.04742283532074088,Bolívar,31691,0.9719163169354075,0.011927676627433657,0.016156006437158813
2009,13,35579,568,487,1055,1896988,0.029942203113567403,0.025672276261104444,1.8755521911577722,0.05561447937467185,Bolívar,36634,0.9712016159851504,0.015504722389037506,0.013293661625812088
2010,13,30875,529,368,897,1916100,0.02760816241323522,0.019205678200511455,1.6113459631543239,0.046813840613746674,Bolívar,31772,0.9717675941080196,0.01664988039783457,0.011582525494145788
2011,13,35036,507,393,900,1933804,0.026217755263718556,0.020322638695545153,1.8117658252852926,0.04654039395926371,Bolívar,35936,0.9749554764024934,0.014108414959928763,0.010936108637577916
2012,13,37299,929,480,1409,1950314,0.0476333554494302,0.024611421545453708,1.912461275466412,0.0722447769948839,Bolívar,38708,0.9635992559677586,0.02400020667562261,0.012400537356618786
2013,13,35282,1412,428,1840,1965842,0.07182672869945804,0.021771841277172833,1.794752579301897,0.09359856997663088,Bolívar,37122,0.9504337050805453,0.03803674370992942,0.01152955120952535
2014,13,36607,1168,440,1608,1980186,0.05898435803505327,0.022220134876218697,1.8486647213948588,0.08120449291127198,Bolívar,38215,0.957922281826508,0.030563914693183303,0.01151380348030878
2015,13,35680,1035,407,1442,1994311,0.05189762278802052,0.020408050700216767,1.7890890638420989,0.07230567348823728,Bolívar,37122,0.9611551101772534,0.027881040892193308,0.010963848930553311
2016,13,34558,1092,401,1493,2011418,0.054290058058543776,0.01993618432369602,1.718091416105454,0.0742262423822398,Bolívar,36051,0.9585864469778924,0.03029042190230507,0.011123131119802503
2017,13,36935,1152,434,1586,2030869,0.05672448592203633,0.021370162231044938,1.818679589870149,0.07809464815308127,Bolívar,38521,0.9588276524493133,0.02990576568624906,0.01126658186443758
2008,15,19180,269,276,545,1247306,0.02156648007786381,0.022127689596618632,1.537714081388208,0.04369416967448245,Boyacá,19725,0.9723700887198986,0.013637515842839038,0.013992395437262358
2009,15,18680,270,214,484,1245756,0.021673586159729512,0.01717832384511895,1.499491072087953,0.03885191000484846,Boyacá,19164,0.9747443122521394,0.014088916718847839,0.011166771029012732
2010,15,17754,464,222,686,1243898,0.03730209390159,0.017847122513260733,1.427287446398338,0.05514921641485074,Boyacá,18440,0.9627982646420824,0.025162689804772233,0.012039045553145337
2011,15,17156,538,187,725,1241563,0.04333247688598968,0.015061660181561467,1.3818066421115964,0.058394137067551144,Boyacá,17881,0.9594541692299089,0.03008780269559868,0.010458028074492478
2012,15,17227,528,172,700,1238657,0.042626812749615106,0.01388600718358674,1.3907804985560974,0.05651281993320185,Boyacá,17927,0.9609527528309254,0.029452780721816254,0.009594466447258325
2013,15,16339,453,151,604,1235236,0.03667315395600517,0.012224384652001723,1.322743184298385,0.04889753860800689,Boyacá,16943,0.9643510594345748,0.026736705424068936,0.008912235141356313
2014,15,15840,410,132,542,1231277,0.03329876217942835,0.010720577091913517,1.286469251029622,0.04401933927134187,Boyacá,16382,0.9669149066048102,0.025027469173483093,0.008057624221706751
2015,15,15360,460,142,602,1226789,0.03749626056314492,0.011574932608622999,1.252049048369361,0.049071193171767925,Boyacá,15962,0.9622854278912417,0.02881844380403458,0.008896128304723718
2016,15,15157,615,148,763,1222079,0.050324078885243914,0.012110510040676585,1.2402635181522634,0.0624345889259205,Boyacá,15920,0.9520728643216081,0.03863065326633166,0.0092964824120603
2017,15,14700,519,123,642,1216499,0.042663413615629774,0.010110982417576998,1.2083857035640801,0.052774396033206765,Boyacá,15342,0.9581540868204927,0.03382870551427454,0.008017207665232694
2008,17,12502,766,166,932,940316,0.08146197661211763,0.017653639840223924,1.3295530438703584,0.09911561645234156,Caldas,13434,0.9306237903826113,0.057019502754205746,0.012356706863182968
2009,17,11482,839,142,981,942490,0.08901951214336491,0.015066472853823383,1.218262262729578,0.1040859849971883,Caldas,12463,0.9212870095482628,0.06731926502447244,0.011393725427264703
2010,17,10879,692,145,837,945605,0.0731806621157883,0.015334098275707087,1.1504803802856371,0.08851476039149539,Caldas,11716,0.9285592352338682,0.05906452714236941,0.012376237623762377
2011,17,10691,672,129,801,949298,0.07078915156252304,0.013588988916020048,1.1262006240400801,0.0843781404785431,Caldas,11492,0.9302993386703794,0.05847546119039332,0.011225200139227289
2012,17,10555,660,134,794,953249,0.06923689403293368,0.014057187576383506,1.107265782602447,0.08329408160931719,Caldas,11349,0.9300378888007754,0.05815490351572826,0.011807207683496343
2013,17,10181,601,124,725,957620,0.06275975856811679,0.012948768822706293,1.0631565756771997,0.07570852739082308,Caldas,10906,0.9335228314689162,0.055107280396112235,0.011369888134971575
2014,17,10047,542,90,632,962880,0.05628946493851778,0.009346959122632104,1.0434322033898304,0.06563642406114989,Caldas,10679,0.9408184286918251,0.0507538159003652,0.00842775540780972
2015,17,9731,472,114,586,969209,0.04869950650478896,0.011762168943953264,1.0040146139790282,0.06046167544874222,Caldas,10317,0.9432005427934477,0.04574973344964622,0.011049723756906077
2016,17,9563,361,95,456,976624,0.03696407215059225,0.00972738740805059,0.9791895345598716,0.04669145955864284,Caldas,10019,0.9544864756961773,0.03603154007385967,0.00948198422996307
2017,17,9295,278,85,363,984735,0.0282309453812447,0.00863176387556043,0.9439087673333435,0.03686270925680513,Caldas,9658,0.9624145785876993,0.028784427417684822,0.008800993994615862
2008,18,7125,127,195,322,330358,0.03844314349887092,0.05902687387621913,2.156751160861853,0.09747001737509005,Caquetá,7447,0.9567611118571236,0.017053847186786625,0.0261850409560897
2009,18,7225,96,142,238,336689,0.028512960031364255,0.042175420046392964,2.145897252360487,0.07068838007775721,Caquetá,7463,0.9681093394077449,0.012863459734691144,0.019027200857563983
2010,18,7134,107,118,225,343162,0.03118060857554158,0.03438609170012997,2.078901510073959,0.06556670027567155,Caquetá,7359,0.9694251936404403,0.014540019024323957,0.016034787335235764
2011,18,7408,81,116,197,349751,0.02315933335430063,0.03316645270492436,2.1180782899834454,0.05632578605922499,Caquetá,7605,0.9740959894806048,0.010650887573964497,0.015253122945430637
2012,18,7817,81,106,187,356438,0.02272484976349323,0.029738692283089906,2.1930882790274886,0.052463542046583135,Caquetá,8004,0.9766366816591704,0.010119940029985007,0.013243378310844578
2013,18,7751,72,95,167,363283,0.01981925936528822,0.026150411662533065,2.1335983241715137,0.045969671027821284,Caquetá,7918,0.9789088153574135,0.009093205354887599,0.011997979287698914
2014,18,7549,259,72,331,370412,0.06992214075137955,0.01943781518957269,2.0380009286956144,0.08935995594095224,Caquetá,7880,0.957994923857868,0.03286802030456853,0.009137055837563452
2015,18,7330,415,65,480,377925,0.10981014751604154,0.017199179731428194,1.9395382681749025,0.12700932724746974,Caquetá,7810,0.93854033290653,0.05313700384122919,0.008322663252240717
2016,18,6883,576,75,651,385914,0.14925605186647803,0.01943438175344766,1.783557994786403,0.1686904336199257,Caquetá,7534,0.9135917175471198,0.07645341120254845,0.009954871250331829
2017,18,7226,454,80,534,394539,0.11507100692200264,0.02027682941356875,1.831504616780597,0.13534783633557138,Caquetá,7760,0.9311855670103093,0.05850515463917526,0.010309278350515464
2008,19,17285,352,284,636,1268319,0.02775327027348798,0.022391843061564165,1.3628274905603401,0.050145113335052144,Cauca,17921,0.9645109089894537,0.019641761062440713,0.015847329948105573
2009,19,17507,299,328,627,1287169,0.023229272923757486,0.025482279327733965,1.3601166591178004,0.04871155225149145,Cauca,18134,0.9654240652917172,0.01648836439836771,0.018087570309915077
2010,19,17028,364,269,633,1305905,0.02787339048399386,0.020598741868665792,1.3039233328611193,0.04847213235265965,Cauca,17661,0.9641583149312043,0.020610384462940945,0.015231300605854708
2011,19,16797,491,249,740,1324424,0.03707271991446848,0.018800625781471795,1.2682494427766335,0.055873345695940276,Cauca,17537,0.9578035011689571,0.027997947197354166,0.014198551633688772
2012,19,17677,789,271,1060,1342625,0.058765478074667164,0.020184340377990877,1.3165999441392795,0.07894981845265804,Cauca,18737,0.9434274430271655,0.042109195709024924,0.014463361263809574
2013,19,18157,1083,233,1316,1360715,0.07959050940130741,0.01712335059141701,1.3343720029543291,0.09671385999272442,Cauca,19473,0.9324192471627382,0.055615467570482205,0.011965285266779644
2014,19,18331,1300,220,1520,1379169,0.09425965925858253,0.01595163464376012,1.3291337029762125,0.11021129390234265,Cauca,19851,0.9234295501486072,0.06548788474132286,0.011082565110070022
2015,19,18208,1304,231,1535,1398252,0.09325929803783581,0.016520627183082878,1.3021973149332167,0.10977992522091869,Cauca,19743,0.9222509243782606,0.06604872613078053,0.011700349490958821
2016,19,18190,1281,199,1480,1418047,0.09033551074118136,0.014033385353235823,1.2827501486198976,0.10436889609441719,Cauca,19670,0.9247585155058464,0.06512455516014234,0.010116929334011185
2017,19,18780,1199,221,1420,1438502,0.08335059666236126,0.015363204222170008,1.3055247750785193,0.09871380088453127,Cauca,20200,0.9297029702970298,0.059356435643564354,0.01094059405940594
2008,20,20945,428,399,827,966278,0.044293671179515624,0.04129246448744564,2.1675956608760627,0.08558613566696127,Cesar,21772,0.9620154326658092,0.019658276685651295,0.018326290648539408
2009,20,20682,477,346,823,984735,0.048439427866380294,0.03513635648169305,2.1002604761687156,0.08357578434807333,Cesar,21505,0.9617298302720297,0.022180888165542898,0.01608928156242734
2010,20,18673,715,306,1021,1003449,0.07125424411205751,0.030494823354251188,1.8608818186076224,0.1017490674663087,Cesar,19694,0.9481567990250838,0.03630547374834975,0.015537727226566466
2011,20,20813,232,286,518,1022255,0.022694924456226676,0.02797736376931392,2.035989063394163,0.050672288225540596,Cesar,21331,0.9757160939477756,0.010876189583235666,0.013407716468988796
2012,20,20918,272,346,618,1041453,0.026117357192307285,0.03322281466374383,2.008539991723102,0.059340171856051116,Cesar,21536,0.9713038632986627,0.01263001485884101,0.016066121842496284
2013,20,20753,289,265,554,1061257,0.02723185807019412,0.02497038888789426,1.955511247511206,0.05220224695808838,Cesar,21307,0.9739991552072089,0.013563617590463229,0.012437227202327874
2014,20,21607,254,281,535,1081319,0.023489830475558093,0.02598678095918041,1.9982077444306445,0.0494766114347385,Cesar,22142,0.9758377743654593,0.011471411796585675,0.012690813837955018
2015,20,20768,274,279,553,1102461,0.024853486880715054,0.025307017663209856,1.8837854581704023,0.05016050454392491,Cesar,21321,0.9740631302471742,0.012851179588199427,0.013085690164626424
2016,20,20701,457,309,766,1127772,0.04052237509000046,0.027399155148381055,1.8355660541315089,0.06792153023838152,Cesar,21467,0.9643173242651512,0.021288489309172216,0.01439418642567662
2017,20,20504,318,298,616,1156930,0.027486537647048656,0.025757824587485847,1.7722766286637912,0.0532443622345345,Cesar,21120,0.9708333333333333,0.015056818181818182,0.014109848484848486
2008,23,26011,1969,449,2418,1593252,0.12358371431512404,0.02818135486413951,1.6325728761049727,0.15176506917926355,Córdoba,28429,0.9149460058391079,0.0692602624081044,0.015793731752787647
2009,23,25445,1599,505,2104,1615297,0.09899108337352203,0.031263600440042914,1.57525210534038,0.13025468381356495,Córdoba,27549,0.9236269919053323,0.05804203419361864,0.01833097390104904
2010,23,23092,1879,360,2239,1636683,0.11480537159608795,0.02199570717115043,1.410902416656127,0.13680107876723838,Córdoba,25331,0.9116102798942007,0.07417788480517942,0.014211835300619794
2011,23,27363,2543,409,2952,1657170,0.15345438307475998,0.02468063023105656,1.6511884719129601,0.17813501330581655,Córdoba,30315,0.9026224641266699,0.0838858650832921,0.013491670790037935
2012,23,28150,2699,445,3144,1676670,0.16097383504207746,0.026540702702380313,1.6789231035325973,0.18751453774445775,Córdoba,31294,0.899533456892695,0.08624656483670991,0.014219978270595002
2013,23,26864,2613,418,3031,1695139,0.1541466511005882,0.02465874479909907,1.5847667949354005,0.17880539589968727,Córdoba,29895,0.8986118079946479,0.08740592072252885,0.013982271282823214
2014,23,27291,2792,416,3208,1712397,0.16304630293092082,0.024293431955323443,1.5937308930113754,0.18733973488624425,Córdoba,30499,0.8948162234827371,0.09154398504869012,0.01363979146857274
2015,23,26295,2500,431,2931,1728524,0.1446320675906149,0.024934568452622007,1.5212400869180873,0.16956663604323688,Córdoba,29226,0.8997125846848696,0.0855402723602272,0.014747142954903168
2016,23,25919,2873,392,3265,1744183,0.16471895437577364,0.022474705922486345,1.4860252622574581,0.18719366029825998,Córdoba,29184,0.8881236293859649,0.09844435307017543,0.01343201754385965
2017,23,26668,3057,401,3458,1758886,0.1738031913381538,0.02279852133680068,1.5161869501491285,0.1966017126749545,Córdoba,30126,0.8852154285334927,0.10147380999800837,0.013310761468498971
2008,25,37247,2344,498,2842,2376773,0.09862111358552121,0.020952779251531384,1.5671248369112238,0.1195738928370526,Cundinamarca,40089,0.929107735288982,0.05846990446257078,0.012422360248447204
2009,25,35958,2498,426,2924,2414808,0.10344507720696636,0.01764115407933053,1.4890624844708151,0.12108623128629688,Cundinamarca,38882,0.9247981070932565,0.06424566637518646,0.010956226531557018
2010,25,34475,2649,379,3028,2455822,0.10786612384773815,0.01543271458599198,1.4038069534355504,0.12329883843373013,Cundinamarca,37503,0.9192597925499293,0.07063434925205983,0.010105858198010825
2011,25,33575,2620,386,3006,2499291,0.10482972971134613,0.015444380026175424,1.3433809828467353,0.12027410973752156,Cundinamarca,36581,0.9178261939258084,0.07162188021103852,0.010551925863153002
2012,25,34239,3180,410,3590,2545277,0.12493728580425628,0.016108266408724866,1.345197398947148,0.14104555221298115,Cundinamarca,37829,0.9050992624705914,0.08406249173914193,0.010838245790266727
2013,25,34281,3205,375,3580,2594392,0.12353568774495143,0.014454253636304768,1.3213500504164366,0.1379899413812562,Cundinamarca,37861,0.9054435963128286,0.0846517524629566,0.009904651224214892
2014,25,34934,2903,322,3225,2646623,0.10968694823554394,0.01216644758244752,1.319946210699446,0.12185339581799146,Cundinamarca,38159,0.915485206635394,0.07607641709688409,0.008438376267721901
2015,25,35949,2978,349,3327,2702705,0.11018590634197961,0.012912989023959329,1.330111869404911,0.12309889536593895,Cundinamarca,39276,0.9152917812404522,0.07582238517160607,0.008885833587941745
2016,25,35594,2751,403,3154,2765620,0.09947136627591643,0.01457177775688634,1.2870170160759613,0.11404314403280277,Cundinamarca,38748,0.9186022504387323,0.07099721275936823,0.010400536801899453
2017,25,35771,2260,336,2596,2833801,0.07975154218662496,0.01185686644898495,1.262297529007859,0.09160840863560991,Cundinamarca,38367,0.9323376860322673,0.05890478796882738,0.00875752599890531
2008,27,5508,123,173,296,435933,0.028215345018615248,0.03968499746520681,1.2634969135165266,0.06790034248382205,Chocó,5804,0.9490006891798759,0.021192281185389388,0.029807029634734666
2009,27,5454,126,204,330,447513,0.028155606652767628,0.04558526791400473,1.218735545112656,0.07374087456677236,Chocó,5784,0.9429460580912863,0.021784232365145227,0.035269709543568464
2010,27,5564,136,188,324,458775,0.029644161081139993,0.04097869325922293,1.2127949430548743,0.07062285434036292,Chocó,5888,0.9449728260869565,0.02309782608695652,0.03192934782608696
2011,27,6106,96,149,245,469671,0.020439839802755547,0.03172433469386017,1.3000589774544309,0.052164174496615714,Chocó,6351,0.961423397890096,0.015115729806329713,0.02346087230357424
2012,27,6233,112,165,277,480181,0.02332453803878121,0.03436204264641875,1.298052192818958,0.057686580685199954,Chocó,6510,0.9574500768049156,0.017204301075268817,0.02534562211981567
2013,27,6706,151,153,304,490310,0.030796842813730088,0.03120474801656095,1.3677061450918806,0.06200159083029104,Chocó,7010,0.9566333808844508,0.021540656205420828,0.021825962910128387
2014,27,7149,174,179,353,500091,0.034793667552505445,0.03579348558562342,1.429539823752077,0.07058715313812886,Chocó,7502,0.9529458810983737,0.023193814982671288,0.023860303918954946
2015,27,6699,231,190,421,509545,0.045334563188727195,0.037288168856528865,1.3147023324730887,0.08262273204525607,Chocó,7120,0.940870786516854,0.0324438202247191,0.026685393258426966
2016,27,5855,190,171,361,518731,0.03662784757417621,0.03296506281675859,1.1287160397200091,0.0695929103909348,Chocó,6216,0.9419240669240669,0.030566280566280565,0.02750965250965251
2017,27,6300,164,161,325,527700,0.031078264165245405,0.03050975933295433,1.1938601478112565,0.06158802349819974,Chocó,6625,0.9509433962264151,0.024754716981132074,0.02430188679245283
2008,41,20549,1915,284,2199,1043622,0.18349555682038132,0.027212918087200156,1.969007935823507,0.2107084749075815,Huila,22748,0.903332161069105,0.08418322489889221,0.012484614032002813
2009,41,19792,1673,239,1912,1050376,0.15927629724974676,0.022753756749963824,1.8842776301057906,0.1820300539997106,Huila,21704,0.9119056395134537,0.07708256542572797,0.011011795060818282
2010,41,18698,2008,200,2208,1057179,0.18993945207008464,0.018918272118534325,1.7686692603617742,0.20885772418861895,Huila,20906,0.8943843872572467,0.09604898115373577,0.009566631589017507
2011,41,20013,2577,186,2763,1063845,0.24223453604613454,0.01748374998237525,1.8811950989100856,0.25971828602850977,Huila,22776,0.8786880927291886,0.11314541622760801,0.008166491043203371
2012,41,20943,2411,224,2635,1070159,0.22529362459223348,0.020931469062073955,1.9569989132456018,0.24622509365430745,Huila,23578,0.8882432776316905,0.10225634065654424,0.009500381711765205
2013,41,20732,2770,205,2975,1076046,0.25742393912527906,0.01905123015187083,1.9266834317492003,0.2764751692771499,Huila,23707,0.8745096385033956,0.11684312650272072,0.008647234993883663
2014,41,20173,2648,220,2868,1081576,0.24482791777924065,0.020340688033018483,1.8651486349549176,0.26516860581225915,Huila,23041,0.8755262358404583,0.11492556746668982,0.009548196692851873
2015,41,19543,2497,186,2683,1086659,0.22978689726952062,0.017116685179067215,1.7984482712608094,0.24690358244858782,Huila,22226,0.8792855214613515,0.11234590119679655,0.008368577341851886
2016,41,19435,2664,204,2868,1090990,0.24418188984316996,0.018698613186188692,1.7814095454587118,0.26288050302935867,Huila,22303,0.8714074339774918,0.11944581446442183,0.009146751558086356
2017,41,19689,2493,183,2676,1093975,0.22788454946411024,0.016727987385452135,1.7997669050938092,0.24461253684956238,Huila,22365,0.8803487592219986,0.11146881287726358,0.00818242790073776
2008,44,12725,149,237,386,628905,0.023691972555473402,0.03768454695065233,2.0233580588483155,0.06137651950612573,La Guajira,13111,0.970559072534513,0.011364503089009229,0.018076424376477766
2009,44,12608,148,257,405,649933,0.022771577993423938,0.03954253746155373,1.939892265818169,0.06231411545497767,La Guajira,13013,0.9688772765695842,0.011373242142472912,0.019749481287942825
2010,44,12167,150,221,371,670808,0.02236109289096135,0.032945343526016385,1.813782781362178,0.05530643641697774,La Guajira,12538,0.9704099537406284,0.011963630563088213,0.017626415696283298
2011,44,12676,284,251,535,691488,0.041070850108750986,0.03629853301864964,1.8331482252765052,0.07736938312740062,La Guajira,13211,0.959503444099614,0.021497237150859133,0.01899931874952691
2012,44,13254,210,247,457,712422,0.029476911156589774,0.03467046216989369,1.8604141927116231,0.06414737332648346,La Guajira,13711,0.9666690978046824,0.015316169498942454,0.018014732696375175
2013,44,13165,147,242,389,733953,0.02002853043723508,0.032972138542931226,1.7937115864367337,0.0530006689801663,La Guajira,13554,0.9712999852442084,0.010845506861443116,0.01785450789434853
2014,44,14688,149,264,413,755815,0.019713818857789275,0.03492918240574744,1.9433326938470392,0.05464300126353671,La Guajira,15101,0.972650817826634,0.009866896232037613,0.01748228594132839
2015,44,15265,189,240,429,778983,0.024262403672480656,0.030809401488864328,1.9596063071979748,0.05507180516134499,La Guajira,15694,0.9726647126290302,0.012042818911685994,0.015292468459283802
2016,44,16031,215,298,513,806803,0.02664838876404773,0.036935906286912665,1.9869782338439494,0.0635842950509604,La Guajira,16544,0.9689917794970987,0.012995647969052225,0.01801257253384913
2017,44,17677,232,286,518,839302,0.027642016818737476,0.03407593452654706,2.1061548763138895,0.06171795134528454,La Guajira,18195,0.9715306402857928,0.012750755702115965,0.015718604012091235
2008,47,22327,217,409,626,1205692,0.01799796299552456,0.033922427950090074,1.851799630419709,0.05192039094561463,Magdalena,22953,0.9727268766610029,0.009454101860323269,0.017819021478673813
2009,47,22770,224,400,624,1219122,0.01837387890629486,0.03281049804695511,1.8677376013229192,0.05118437695324996,Magdalena,23394,0.9733264939728136,0.009575104727707959,0.0170984012994785
2010,47,21175,181,314,495,1231539,0.014697057908844137,0.025496553499320767,1.7193933769048322,0.04019361140816491,Magdalena,21670,0.9771573604060914,0.008352561144439318,0.014490078449469312
2011,47,22718,324,317,641,1242844,0.026069241191975824,0.025506016845235603,1.8279043870348974,0.05157525803721143,Magdalena,23359,0.9725587567960957,0.013870456783252707,0.013570786420651569
2012,47,23511,563,329,892,1253378,0.04491861194308501,0.02624906452801948,1.8758108088701093,0.07116767647110449,Magdalena,24403,0.9634471171577265,0.02307093390156948,0.013481948940704012
2013,47,22989,819,348,1167,1263418,0.06482415162677752,0.027544328163758947,1.8195878165421104,0.09236847979053646,Magdalena,24156,0.9516890213611525,0.03390461997019374,0.014406358668653751
2014,47,22836,951,316,1267,1272648,0.0747260829388802,0.024830117990206246,1.7943689064061705,0.09955620092908644,Magdalena,24103,0.9474339293863835,0.03945566941874455,0.013110401194872008
2015,47,22242,959,291,1250,1281842,0.0748142126720766,0.022701705826459112,1.7351592473955448,0.0975159184985357,Magdalena,23492,0.946790396730802,0.04082240762812873,0.0123871956410693
2016,47,21632,1009,256,1265,1293944,0.07797864513456533,0.019784472898363454,1.6717879599117118,0.09776311803292878,Magdalena,22897,0.9447525876752413,0.044066908328602,0.011180503996156702
2017,47,23467,1126,301,1427,1308191,0.0860730581390638,0.023008872557600535,1.7938512036850889,0.10908193069666433,Magdalena,24894,0.9426769502691411,0.04523178275889773,0.012091266971961116
2008,50,15741,736,230,966,812684,0.09056410609781908,0.02830128315556846,1.9369152093556659,0.11886538925338754,Meta,16707,0.9421799245825103,0.04405339079427785,0.013766684623211827
2009,50,15520,1464,241,1705,836720,0.17496892628358351,0.028802944832201933,1.8548618414762406,0.20377187111578546,Meta,17225,0.9010159651669085,0.08499274310595065,0.013991291727140785
2010,50,15107,1729,165,1894,860497,0.2009303925522111,0.019174965165479948,1.7556133257873066,0.22010535771769105,Meta,17001,0.8885947885418505,0.10169990000588201,0.009705311452267513
2011,50,15209,2207,186,2393,883858,0.24970074378463508,0.021044104369706447,1.72075152343476,0.2707448481543415,Meta,17602,0.8640495398250199,0.12538347915009657,0.010566981024883536
2012,50,15630,2412,192,2604,906690,0.26602256559573834,0.02117592561956126,1.723852694967409,0.2871984912152996,Meta,18234,0.8571898650871997,0.13228035538005922,0.010529779532741033
2013,50,15374,2080,179,2259,929042,0.2238865411897417,0.01926715907354027,1.6548229251207158,0.24315370026328195,Meta,17633,0.8718879373901208,0.11796064197810922,0.010151420631769976
2014,50,15700,2166,197,2363,951062,0.22774540461084555,0.02071368638427358,1.6507861737720568,0.24845909099511915,Meta,18063,0.8691800919005702,0.11991363560870287,0.0109062724907269
2015,50,15859,2095,156,2251,972890,0.21533780797418,0.016034700736979515,1.6300917883830648,0.23137250871115952,Meta,18110,0.8757040309221424,0.11568194367752622,0.008614025400331309
2016,50,14806,1953,163,2116,994750,0.19633073636592108,0.01638602663985926,1.4884141744156822,0.21271676300578035,Meta,16922,0.8749556789977544,0.11541188984753575,0.009632431154709846
2017,50,15297,1633,131,1764,1016553,0.16064091100021347,0.012886686675461093,1.5047911914086132,0.17352759767567455,Meta,17061,0.8966062950589063,0.09571537424535491,0.0076783306957388196
2008,52,20843,520,309,829,1560792,0.033316418843766495,0.019797641197545863,1.3354117653088944,0.05311406004131236,Nariño,21672,0.9617478774455519,0.02399409376153562,0.014258028792912514
2009,52,20329,782,304,1086,1573383,0.04970182085353662,0.019321423963523186,1.2920566702449436,0.0690232448170598,Nariño,21415,0.9492878823254728,0.036516460424935795,0.014195657249591409
2010,52,18734,1187,271,1458,1584807,0.07489871006374908,0.01709987399096546,1.182099776187258,0.09199858405471455,Nariño,20192,0.9277931854199684,0.05878565768621236,0.013421156893819335
2011,52,18283,1566,274,1840,1594919,0.09818680447094806,0.01717955582697303,1.1463278072428758,0.11536636029792109,Nariño,20123,0.9085623415991652,0.07782139839984098,0.013616260000993887
2012,52,17630,1688,238,1926,1603360,0.10527891428001197,0.014843827961281308,1.0995659115856702,0.12012274224129328,Nariño,19556,0.9015136019635918,0.08631622008590714,0.012170177950501125
2013,52,17598,1720,212,1932,1610045,0.1068293122241925,0.013167333832284191,1.0930129282100811,0.11999664605647668,Nariño,19530,0.9010752688172043,0.08806963645673323,0.010855094726062468
2014,52,18454,2311,224,2535,1615776,0.1430272513021607,0.013863307785237557,1.1421137583427405,0.15689055908739824,Nariño,20989,0.8792224498546858,0.11010529324884463,0.010672256896469579
2015,52,18030,2311,215,2526,1620711,0.14259173905773453,0.013265782733627402,1.112474710173498,0.15585752179136195,Nariño,20556,0.8771161704611792,0.1124245962249465,0.010459233313874295
2016,52,17804,2095,175,2270,1623670,0.12902868193660041,0.010778052190408149,1.0965282354172954,0.13980673412700856,Nariño,20074,0.8869184019129221,0.10436385374115771,0.008717744345920096
2017,52,18208,1894,175,2069,1623923,0.1166311456885579,0.010776373017686183,1.1212354280344572,0.1274075187062441,Nariño,20277,0.8979632095477634,0.09340632243428515,0.008630468017951374
2008,54,21541,259,390,649,1303351,0.019871853399429623,0.029922868053195186,1.6527397454714807,0.04979472145262481,Norte de Santander,22190,0.9707525912573232,0.01167192429022082,0.01757548445245606
2009,54,21776,271,289,560,1318403,0.020555171673608146,0.02192045982905075,1.6516952707176789,0.0424756315026589,Norte de Santander,22336,0.9749283667621776,0.012132879656160458,0.012938753581661891
2010,54,20251,316,257,573,1332538,0.023714145487783462,0.019286504399874525,1.5197315198515915,0.04300064988765799,Norte de Santander,20824,0.9724836726853631,0.01517479830964272,0.012341529004994238
2011,54,21273,332,259,591,1345383,0.02467698789118043,0.019251023686191963,1.581185431955064,0.04392801157737239,Norte de Santander,21864,0.9729692645444566,0.015184778631540432,0.011845956824002928
2012,54,20855,317,229,546,1357528,0.023351267892816944,0.016868896995126437,1.5362482394469947,0.04022016488794338,Norte de Santander,21401,0.9744871734965656,0.014812391944301668,0.01070043455913275
2013,54,20108,285,202,487,1369326,0.02081315917465965,0.014751782993969296,1.4684596655580922,0.035564942168628946,Norte de Santander,20595,0.9763534838553047,0.013838310269482883,0.00980820587521243
2014,54,20424,436,200,636,1380095,0.031592028085023136,0.01449175600230419,1.4798981229553039,0.04608378408732732,Norte de Santander,21060,0.9698005698005698,0.02070275403608737,0.00949667616334283
2015,54,20454,541,213,754,1391555,0.038877370998631026,0.015306617417205931,1.4698664443733809,0.05418398841583696,Norte de Santander,21208,0.9644473783477933,0.02550924179554885,0.010043379856657864
2016,54,20468,1676,226,1902,1409886,0.11887485938579431,0.016029664809778948,1.4517485810909534,0.13490452419557325,Norte de Santander,22370,0.9149754135002235,0.07492177022798391,0.010102816271792579
2017,54,21033,2313,209,2522,1434070,0.16128919787737,0.014573905039502953,1.4666648071572517,0.17586310291687296,Norte de Santander,23555,0.8929314370621949,0.09819571216302271,0.008872850774782424
2008,63,6730,535,98,633,550322,0.09721581183379913,0.017807756186378157,1.222920399329847,0.11502356802017728,Quindio,7363,0.9140296074969442,0.07266060029879125,0.013309792204264566
2009,63,6535,592,103,695,550951,0.10745057182943674,0.018694947463567542,1.186130890042853,0.12614551929300427,Quindio,7230,0.9038727524204703,0.08188105117565699,0.014246196403872752
2010,63,6151,734,86,820,551570,0.1330746777380931,0.015591855974762949,1.1151803034972896,0.14866653371285604,Quindio,6971,0.882369817816669,0.10529335819824989,0.01233682398508105
2011,63,6067,764,76,840,551815,0.13845219865353425,0.013772731803231155,1.0994626822395186,0.1522249304567654,Quindio,6907,0.8783842478644853,0.1106124221803967,0.011003329955117996
2012,63,5962,619,72,691,551306,0.1122788433283875,0.013059897770022456,1.0814320903454706,0.12533874109840995,Quindio,6653,0.8961370810160829,0.09304073350368255,0.01082218548023448
2013,63,5898,517,60,577,550129,0.09397795789714776,0.010906532831390457,1.0721121773256819,0.10488449072853821,Quindio,6475,0.9108880308880309,0.07984555984555984,0.009266409266409266
2014,63,5862,457,60,517,548791,0.08327396039658085,0.010933123903271008,1.0681662053495775,0.09420708429985186,Quindio,6379,0.9189528139206772,0.07164132309139364,0.009405862987929142
2015,63,5994,417,66,483,547423,0.07617509677160075,0.01205649013651235,1.0949485133068944,0.0882315869081131,Quindio,6477,0.9254284390921723,0.06438165817508106,0.010189902732746642
2016,63,5843,364,65,429,545719,0.06670099446784884,0.01191089186925872,1.070697556801211,0.07861188633710756,Quindio,6272,0.9316007653061225,0.05803571428571429,0.010363520408163265
2017,63,5853,353,67,420,543089,0.06499855456472144,0.0123368361355137,1.0777239089725625,0.07733539070023514,Quindio,6273,0.9330463892874223,0.05627291567033317,0.01068069504224454
2008,66,12977,661,169,830,926053,0.07137820405527545,0.01824949543924592,1.4013236823378359,0.08962769949452137,Risaralda,13807,0.9398855652929673,0.04787426667632361,0.012240168030709061
2009,66,12284,433,153,586,931434,0.04648745912217076,0.016426284632083434,1.318826669415117,0.0629137437542542,Risaralda,12870,0.9544677544677544,0.03364413364413364,0.011888111888111888
2010,66,11822,438,138,576,936744,0.046757705413645566,0.01473187978786093,1.2620310351600865,0.06148958520150649,Risaralda,12398,0.953540893692531,0.03532827875463784,0.011130827552831101
2011,66,11986,1154,121,1275,941267,0.12260070734446231,0.012855013508388162,1.2733900157978555,0.13545572085285046,Risaralda,13261,0.9038534047206093,0.08702209486464067,0.00912450041475002
2012,66,11904,1133,126,1259,944167,0.11999995763461337,0.013345096789021434,1.2607939061627869,0.1333450544236348,Risaralda,13163,0.9043531109929347,0.08607460305401504,0.009572285953050217
2013,66,11302,1075,129,1204,945518,0.11369429244075734,0.01364331509289088,1.195323621549246,0.12733760753364823,Risaralda,12506,0.9037262114185192,0.08595873980489366,0.010315048776587237
2014,66,11130,1054,111,1165,946424,0.11136657565742204,0.011728358536977084,1.176005680329324,0.12309493419439912,Risaralda,12295,0.9052460349735665,0.0857259048393656,0.009028060187067914
2015,66,10939,970,118,1088,947125,0.10241520390655932,0.012458756763890721,1.1549689850864457,0.11487396067045004,Risaralda,12027,0.9095368753637648,0.08065186663340816,0.009811258002826973
2016,66,10853,891,120,1011,946730,0.09411342198937395,0.012675208348737232,1.1463669684070432,0.10678863033811119,Risaralda,11864,0.9147842211732974,0.07510114632501685,0.010114632501685773
2017,66,10561,726,117,843,944007,0.07690620938192196,0.012393975892127918,1.1187417042458372,0.08930018527404987,Risaralda,11404,0.9260785689231849,0.06366187302700807,0.010259558049807086
2008,68,32609,466,320,786,2047053,0.022764432576977734,0.015632228379040502,1.592972922537912,0.038396660956018236,Santander,33395,0.976463542446474,0.013954184758197334,0.009582272795328643
2009,68,30086,380,313,693,2062496,0.018424278156175818,0.015175787007586924,1.4587179805439623,0.033600065163762745,Santander,30779,0.9774846486240618,0.01234608011956204,0.0101692712563761
2010,68,29536,497,307,804,2077071,0.023927925429607366,0.01478042878649791,1.422002425530952,0.03870835421610527,Santander,30340,0.9735003295978906,0.016381015161502966,0.01011865524060646
2011,68,30723,773,252,1025,2090249,0.03698124003408206,0.012055979933491178,1.469824886891466,0.049037219967573244,Santander,31748,0.9677145017008946,0.024347990424593676,0.00793750787451178
2012,68,31272,860,260,1120,2102024,0.0409129486628126,0.01236903099108288,1.4877089890505533,0.053281979653895487,Santander,32392,0.9654235613731785,0.02654976537416646,0.008026673252654977
2013,68,30611,778,294,1072,2112672,0.036825404038109084,0.013916026718771301,1.448923448599688,0.05074143075688039,Santander,31683,0.9661648202506076,0.024555755452450843,0.009279424296941577
2014,68,30968,806,290,1096,2122075,0.03798169244725092,0.013665869490946362,1.4593263668814722,0.051647561938197285,Santander,32064,0.965818363273453,0.025137225548902197,0.00904441117764471
2015,68,30945,1189,236,1425,2131011,0.055795113211522605,0.011074555692110459,1.4521276520862634,0.06686966890363306,Santander,32370,0.9559777571825765,0.03673154155081866,0.007290701266604881
2016,68,29822,1310,252,1562,2142351,0.06114777643812802,0.01176277836825058,1.3920221289601937,0.0729105548063786,Santander,31384,0.950229416263064,0.04174101452969666,0.008029569207239358
2017,68,30062,1351,170,1521,2155034,0.06269042622993419,0.007888506631449898,1.394966390321452,0.07057893286138409,Santander,31583,0.951841180381851,0.042776177057277646,0.0053826425608713546
2008,70,15942,770,205,975,817004,0.09424678459346589,0.02509167641774092,1.9512756363493937,0.1193384610112068,Sucre,16917,0.9423656676715729,0.04551634450552698,0.012117987822900042
2009,70,15476,826,168,994,824591,0.10017087259016895,0.020373736798000464,1.8768092302729473,0.12054460938816941,Sucre,16470,0.9396478445658774,0.050151791135397694,0.010200364298724954
2010,70,14266,828,127,955,832054,0.09951277200758604,0.015263432421453416,1.7145521805075152,0.11477620442903946,Sucre,15221,0.9372577360226003,0.054398528348991525,0.00834373562840812
2011,70,15479,662,137,799,839333,0.07887215205407151,0.016322484639588818,1.844202479826243,0.09519463669366032,Sucre,16278,0.9509153458655855,0.040668386779702664,0.008416267354711881
2012,70,15480,828,151,979,846534,0.09781060181871018,0.01783744066983724,1.828632990523712,0.11564804248854742,Sucre,16459,0.9405188650586306,0.05030682301476396,0.009174311926605505
2013,70,14863,1044,151,1195,853740,0.12228547332911659,0.01768688359453698,1.7409281514278352,0.13997235692365356,Sucre,16058,0.9255822642919417,0.06501432307883921,0.009403412629219081
2014,70,15090,1065,188,1253,860831,0.12371766351351195,0.021839362197690372,1.7529573168252537,0.14555702571120233,Sucre,16343,0.9233310897632013,0.06516551428746252,0.011503395949336108
2015,70,14558,806,165,971,868140,0.09284216831386642,0.01900615108162278,1.6769184693712995,0.11184831939548921,Sucre,15529,0.9374718269045013,0.051902891364543756,0.010625281730954988
2016,70,14398,562,167,729,876886,0.06409042908656314,0.019044664870918226,1.6419466156376086,0.08313509395748137,Sucre,15127,0.951808025385073,0.03715211211740596,0.011039862497520989
2017,70,15467,660,182,842,886784,0.07442624133949191,0.02052359988452656,1.7441676890877598,0.09494984122401848,Sucre,16309,0.9483720645042615,0.04046845300141026,0.011159482494328285
2008,73,21631,1861,264,2125,1340435,0.1388355272728629,0.019695098979062766,1.6137298712731314,0.15853062625192568,Tolima,23756,0.9105489139585788,0.07833810405792221,0.011112981983498905
2009,73,20704,1807,228,2035,1338765,0.13497514500304386,0.017030621505641393,1.5464999458456115,0.15200576650868525,Tolima,22739,0.9105061788117331,0.07946699503056423,0.010026826157702626
2010,73,19565,1548,228,1776,1337101,0.11577285485539238,0.01705181583141438,1.4632402488667648,0.13282467068680676,Tolima,21341,0.9167799072208425,0.07253643221967106,0.010683660559486434
2011,73,19685,1470,207,1677,1335351,0.11008341627032893,0.01550154229112795,1.4741442512118537,0.12558495856145688,Tolima,21362,0.9214961145960117,0.06881378148113472,0.009690103922853665
2012,73,19541,1658,208,1866,1333435,0.12434051903542355,0.01559881059069246,1.465463258426545,0.13993932962611602,Tolima,21407,0.912832251132807,0.07745130097631615,0.009716447890876816
2013,73,18784,1286,190,1476,1331462,0.09658555783041499,0.014270027984275931,1.4107800297717847,0.11085558581469092,Tolima,20260,0.9271470878578479,0.06347482724580454,0.009378084896347482
2014,73,18309,1303,210,1513,1329675,0.09799387068268561,0.015793332957301596,1.376953014834452,0.11378720363998722,Tolima,19822,0.9236706689536878,0.06573504187266674,0.010594289173645445
2015,73,18246,1391,166,1557,1328196,0.10472851898364398,0.012498155392728182,1.3737430319019182,0.11722667437637216,Tolima,19803,0.9213755491592183,0.07024188254304903,0.008382568297732667
2016,73,17607,1196,180,1376,1327052,0.09012457688168964,0.013563899530689077,1.3267754390935698,0.10368847641237872,Tolima,18983,0.9275140915556024,0.06300374018858979,0.009482168255807827
2017,73,17699,940,140,1080,1325839,0.07089850275938481,0.010559351474801993,1.3349282982322892,0.0814578542341868,Tolima,18779,0.9424889504233452,0.05005591352042175,0.007455136056233026
2008,76,60289,1863,804,2667,4185557,0.044510204973913864,0.019208912935602118,1.440405661659846,0.06371911790951598,Valle del Cauca,62956,0.9576370798653028,0.029592096067094478,0.01277082406760277
2009,76,58320,1575,666,2241,4213124,0.03738318644312391,0.015807747410235256,1.3842459894368169,0.05319093385335917,Valle del Cauca,60561,0.9629959875167187,0.026006836082627435,0.010997176400653886
2010,76,54533,1317,619,1936,4242544,0.0310426951376344,0.014590302422320192,1.2853844297195267,0.04563299755995459,Valle del Cauca,56469,0.9657157024207973,0.023322530946182862,0.010961766633019888
2011,76,56093,1418,599,2017,4271578,0.03319616310412686,0.014022920803506339,1.3131681078982989,0.0472190839076332,Valle del Cauca,58110,0.9652899673033901,0.02440199621407675,0.010308036482533128
2012,76,55905,2692,599,3291,4297442,0.06264191581875916,0.013938524359374716,1.3008901574471512,0.07658044017813388,Valle del Cauca,59196,0.944405027366714,0.04547604567876208,0.010118926954523955
2013,76,52518,4754,507,5261,4320101,0.11004372351479745,0.011735836731594933,1.2156660226230822,0.12177956024639239,Valle del Cauca,57779,0.9089461569082192,0.08227902871285415,0.008774814378926599
2014,76,53435,5787,505,6292,4343720,0.13322681940824915,0.011625979575110735,1.230166769497113,0.1448527989833599,Valle del Cauca,59727,0.8946540090746229,0.09689085338289216,0.008455137542484973
2015,76,51780,5731,530,6261,4369781,0.1311507373023957,0.012128754278532494,1.1849564085705897,0.1432794915809282,Valle del Cauca,58041,0.8921279784979583,0.09874054547647353,0.009131476025568132
2016,76,50755,4647,500,5147,4395220,0.10572849595697144,0.011375994830747948,1.1547772352692243,0.11710449078771938,Valle del Cauca,55902,0.9079281599942757,0.08312761618546742,0.008944223820256877
2017,76,51640,3519,519,4038,4415765,0.07969174084218703,0.011753342852257763,1.1694462907333159,0.09144508369444479,Valle del Cauca,55678,0.9274758432414958,0.06320270124645282,0.009321455512051439
2008,81,4831,466,56,522,154394,0.3018252004611578,0.03627083954039665,3.129007603922432,0.33809604000155447,Arauca,5353,0.9024845880814496,0.0870539884177097,0.01046142350084065
2009,81,4704,658,47,705,159983,0.41129369995562026,0.02937812142540145,2.9403124081933707,0.44067182138102173,Arauca,5409,0.8696616749861342,0.12164910334627473,0.008689221667591052
2010,81,4489,649,37,686,166179,0.3905427280221929,0.022265147822528718,2.7013040155494976,0.4128078758447217,Arauca,5175,0.8674396135265701,0.12541062801932368,0.00714975845410628
2011,81,4425,630,48,678,172963,0.3642397506981262,0.027751600053190568,2.5583506299035053,0.39199135075131675,Arauca,5103,0.8671369782480893,0.12345679012345678,0.00940623162845385
2012,81,4478,620,49,669,180519,0.34345415164054754,0.027143957145785207,2.4806253081393095,0.37059810878633276,Arauca,5147,0.8700213716728191,0.12045851952593743,0.009520108801243442
2013,81,3993,662,35,697,188999,0.35026640352594457,0.018518616500616404,2.112709591056037,0.368785020026561,Arauca,4690,0.8513859275053305,0.14115138592750534,0.007462686567164179
2014,81,3989,600,37,637,198319,0.3025428728462729,0.01865681049218683,2.0114058663063044,0.3211996833384598,Arauca,4626,0.8623000432338954,0.1297016861219196,0.00799827064418504
2015,81,4257,662,41,703,208981,0.31677520922954716,0.019619008426603374,2.037027289562209,0.3363942176561506,Arauca,4960,0.8582661290322581,0.13346774193548386,0.008266129032258065
2016,81,4378,650,39,689,222543,0.2920783848514669,0.017524703091088015,1.9672602598149571,0.3096030879425549,Arauca,5067,0.8640221038089599,0.12828103414249062,0.0076968620485494375
2017,81,4589,629,48,677,239211,0.26294777414082127,0.02006596686607221,1.9183900405917789,0.28301374100689347,Arauca,5266,0.8714394227117357,0.11944549943030763,0.009115077857956703
2008,85,6357,56,80,136,323102,0.017331988040928253,0.024759982915611788,1.9674901424318016,0.04209197095654004,Casanare,6493,0.9790543662405667,0.00862467272447251,0.012320961034960727
2009,85,5314,67,65,132,332286,0.020163353255930133,0.019561462113962067,1.599224764209145,0.039724815369892204,Casanare,5446,0.9757620271759089,0.012302607418288652,0.011935365405802425
2010,85,6446,118,79,197,341508,0.034552631270716935,0.023132693816835918,1.8875106878901813,0.057685325087552856,Casanare,6643,0.9703447237693813,0.01776305885894927,0.011892217371669426
2011,85,6513,225,77,302,350718,0.06415410671821806,0.02195496096579018,1.8570475424700186,0.08610906768400824,Casanare,6815,0.9556859867938371,0.03301540719002201,0.011298606016140866
2012,85,7175,245,59,304,359951,0.06806481993382432,0.016391119902431164,1.9933268694905695,0.08445593983625549,Casanare,7479,0.9593528546597139,0.03275839015911218,0.007888755181173953
2013,85,7091,125,49,174,369271,0.03385047837496039,0.013269387522984474,1.9202699372547534,0.04711986589794487,Casanare,7265,0.9760495526496903,0.017205781142463867,0.006744666207845836
2014,85,7050,88,59,147,378685,0.023238311525410303,0.01558023159090009,1.8617056392516207,0.03881854311631039,Casanare,7197,0.9795748228428511,0.012227316937612894,0.008197860219535918
2015,85,6971,118,55,173,388353,0.03038472729707251,0.014162372892703287,1.7950163897279021,0.0445471001897758,Casanare,7144,0.9757838745800672,0.016517357222844344,0.007698768197088466
2016,85,6394,94,50,144,398751,0.023573608592831113,0.012539153506825062,1.6035069504527888,0.03611276209965618,Casanare,6538,0.9779749158764148,0.014377485469562558,0.007647598654022637
2017,85,6440,165,41,206,409927,0.04025106909278969,0.010001780804875014,1.5710114239852462,0.05025284989766471,Casanare,6646,0.9690039121275955,0.024826963587120072,0.006169124285284382
2008,86,4679,69,74,143,269216,0.02562997741590396,0.027487222156186854,1.7380096279567336,0.05311719957209081,Putumayo,4822,0.970344255495645,0.01430941518042306,0.015346329323931979
2009,86,4712,73,61,134,277228,0.02633211652502633,0.022003549425022004,1.6996840146016996,0.04833566595004834,Putumayo,4846,0.9723483285183656,0.015063970284770946,0.012587701196863392
2010,86,4109,98,72,170,285225,0.03435883951266544,0.025243229029713384,1.4406170567096153,0.059602068542378824,Putumayo,4279,0.9602710913764898,0.022902547324141154,0.01682636129936901
2011,86,4354,149,70,219,293029,0.05084820956287603,0.023888420600008873,1.485859761320552,0.0747366301628849,Putumayo,4573,0.9521102121145856,0.03258254974852395,0.015307238136890444
2012,86,4289,139,54,193,300518,0.04625346901017576,0.0179689735722985,1.4272023639183011,0.06422244258247427,Putumayo,4482,0.9569388665774208,0.031012940651494868,0.012048192771084338
2013,86,4320,287,56,343,307845,0.09322873524013708,0.018190972729782845,1.4033036105832482,0.11141970796991993,Putumayo,4663,0.9264422045893201,0.061548359425262704,0.012009435985417113
2014,86,4346,441,54,495,315223,0.139900959003626,0.017130729673913388,1.3787065030153256,0.1570316886775394,Putumayo,4841,0.8977483990910968,0.09109688080975005,0.011154720099153068
2015,86,4490,534,44,578,322749,0.16545364974020058,0.013632884997319898,1.3911739463174169,0.17908653473752048,Putumayo,5068,0.8859510655090765,0.1053670086819258,0.008681925808997633
2016,86,4290,726,50,776,330552,0.21963261453568575,0.015126213122292408,1.2978290858926886,0.23475882765797818,Putumayo,5066,0.8468219502566127,0.14330833004342677,0.00986971969996052
2017,86,4541,725,51,776,338541,0.2141542678730198,0.015064645050377945,1.3413441798777697,0.22921891292339774,Putumayo,5317,0.8540530374271206,0.13635508745533195,0.009591875117547489
2008,88,831,247,18,265,58813,0.4199751755564246,0.030605478380630134,1.4129529185724246,0.4505806539370547,"Archipiélago de San Andrés, Providencia y Santa Catalina",1096,0.7582116788321168,0.22536496350364962,0.016423357664233577
2009,88,869,251,12,263,59121,0.42455303530048544,0.020297356269345916,1.4698668831718003,0.44485039156983136,"Archipiélago de San Andrés, Providencia y Santa Catalina",1132,0.7676678445229682,0.22173144876325088,0.01060070671378092
2010,88,823,170,18,188,59429,0.2860556294065187,0.030288243113631392,1.3848457823621465,0.3163438725201501,"Archipiélago de San Andrés, Providencia y Santa Catalina",1011,0.8140454995054401,0.1681503461918892,0.017804154302670624
2011,88,868,145,7,152,59732,0.24275095426237192,0.011719011585080024,1.453157436549923,0.25446996584745196,"Archipiélago de San Andrés, Providencia y Santa Catalina",1020,0.8509803921568627,0.14215686274509803,0.006862745098039216
2012,88,830,148,18,166,60026,0.24655982407623364,0.02998700563089328,1.3827341485356346,0.2765468297071269,"Archipiélago de San Andrés, Providencia y Santa Catalina",996,0.8333333333333334,0.14859437751004015,0.018072289156626505
2013,88,874,190,12,202,60300,0.3150912106135987,0.01990049751243781,1.449419568822554,0.33499170812603646,"Archipiélago de San Andrés, Providencia y Santa Catalina",1076,0.8122676579925651,0.17657992565055763,0.011152416356877323
2014,88,868,188,19,207,60583,0.3103180760279286,0.031361933215588535,1.4327451595332024,0.34168000924351716,"Archipiélago de San Andrés, Providencia y Santa Catalina",1075,0.8074418604651162,0.17488372093023255,0.017674418604651163
2015,88,830,233,19,252,60896,0.38261954808197585,0.031200735680504466,1.3629795060430898,0.4138202837624803,"Archipiélago de San Andrés, Providencia y Santa Catalina",1082,0.767097966728281,0.21534195933456562,0.01756007393715342
2016,88,880,225,11,236,61202,0.3676350446063854,0.01797326884742329,1.437861507793863,0.3856083134538087,"Archipiélago de San Andrés, Providencia y Santa Catalina",1116,0.7885304659498208,0.20161290322580644,0.00985663082437276
2017,88,854,192,22,214,61504,0.31217481789802287,0.03577003121748179,1.3885275754422477,0.34794484911550466,"Archipiélago de San Andrés, Providencia y Santa Catalina",1068,0.799625468164794,0.1797752808988764,0.020599250936329586
2008,91,1363,16,33,49,52930,0.030228603816361232,0.06234649537124504,2.5750991876062725,0.09257509918760627,Amazonas,1412,0.9652974504249292,0.0113314447592068,0.023371104815864022
2009,91,1252,13,42,55,52794,0.024624010304201235,0.07955449482895784,2.3714816077584575,0.10417850513315907,Amazonas,1307,0.9579188982402448,0.009946442234123947,0.032134659525631215
2010,91,1245,33,29,62,55880,0.05905511811023622,0.05189692197566213,2.2279885468861846,0.11095204008589836,Amazonas,1307,0.9525631216526397,0.0252486610558531,0.02218821729150727
2011,91,1366,19,18,37,58798,0.03231402428654036,0.03061328616619613,2.323208272390217,0.06292731045273649,Amazonas,1403,0.9736279401282965,0.0135424091233072,0.012829650748396294
2012,91,1561,30,30,60,60318,0.04973639709539441,0.04973639709539441,2.587950528863689,0.09947279419078882,Amazonas,1621,0.9629858112276373,0.01850709438618137,0.01850709438618137
2013,91,1410,25,36,61,63091,0.03962530313356897,0.05706043651233932,2.23486709673329,0.09668573964590829,Amazonas,1471,0.9585316111488783,0.01699524133242692,0.024473147518694765
2014,91,1524,26,28,54,65403,0.03975352812562115,0.04281149182759201,2.3301683409017935,0.08256501995321315,Amazonas,1578,0.9657794676806084,0.016476552598225603,0.017743979721166033
2015,91,1490,24,25,49,67310,0.03565592036844451,0.0371415837171297,2.21363838954093,0.07279750408557421,Amazonas,1539,0.96816114359974,0.015594541910331383,0.016244314489928524
2016,91,1322,15,19,34,69917,0.0214540097544231,0.02717507902226926,1.890813393023156,0.048629088776692364,Amazonas,1356,0.9749262536873157,0.011061946902654867,0.014011799410029498
2017,91,1448,25,21,46,72713,0.03438174741793077,0.028880667831061847,1.99139081044655,0.06326241524899262,Amazonas,1494,0.9692101740294511,0.01673360107095047,0.014056224899598393
2008,94,556,38,20,58,22815,0.16655708963401272,0.08766162612316458,2.4369932062239754,0.2542187157571773,Guainía,614,0.9055374592833876,0.06188925081433225,0.03257328990228013
2009,94,600,64,28,92,25271,0.253254718847691,0.11079893949586482,2.374262989197103,0.36405365834355585,Guainía,692,0.8670520231213873,0.09248554913294797,0.04046242774566474
2010,94,567,57,22,79,24921,0.22872276393403154,0.08827896151839813,2.275189599133261,0.31700172545242966,Guainía,646,0.8777089783281734,0.08823529411764706,0.034055727554179564
2011,94,592,83,20,103,27363,0.30332931330628954,0.07309140079669627,2.1635054635822097,0.3764207141029858,Guainía,695,0.8517985611510791,0.11942446043165468,0.02877697841726619
2012,94,501,50,11,61,29353,0.17034033999931864,0.0374748747998501,1.7068102067931727,0.20781521479916873,Guainía,562,0.891459074733096,0.08896797153024912,0.019572953736654804
2013,94,605,66,18,84,32586,0.20254096851408582,0.05523844595838704,1.8566255447124531,0.2577794144724728,Guainía,689,0.8780841799709724,0.09579100145137881,0.026124818577648767
2014,94,601,64,12,76,32368,0.1977261492832427,0.03707365299060801,1.856772120612951,0.23479980227385072,Guainía,677,0.8877400295420975,0.09453471196454949,0.01772525849335303
2015,94,605,28,18,46,36855,0.07597340930674264,0.04884004884004884,1.6415683082349748,0.12481345814679148,Guainía,651,0.9293394777265745,0.043010752688172046,0.027649769585253458
2016,94,661,15,26,41,40422,0.037108505269407746,0.0643214091336401,1.6352481322052348,0.10142991440304784,Guainía,702,0.9415954415954416,0.021367521367521368,0.037037037037037035
2017,94,833,11,18,29,43748,0.025144006583158088,0.04114473804516778,1.9040870439791533,0.06628874462832586,Guainía,862,0.9663573085846868,0.012761020881670533,0.02088167053364269
2008,95,1555,18,25,43,47524,0.0378755996969952,0.052604999579160004,3.2720309738237523,0.0904805992761552,Guaviare,1598,0.9730913642052565,0.011264080100125156,0.015644555694618274
2009,95,1421,15,18,33,49255,0.030453761039488377,0.03654451324738605,2.8849862958075323,0.06699827428687442,Guaviare,1454,0.9773039889958735,0.01031636863823934,0.012379642365887207
2010,95,1339,17,20,37,51297,0.03314033959100922,0.038988634812952026,2.610289100727138,0.07212897440396125,Guaviare,1376,0.9731104651162791,0.012354651162790697,0.014534883720930232
2011,95,1279,77,18,95,53662,0.14349073832507175,0.0335432894785882,2.383437069061906,0.17703402780365995,Guaviare,1374,0.9308588064046579,0.05604075691411936,0.013100436681222707
2012,95,1240,178,15,193,56373,0.3157539957071648,0.02660848278431164,2.199634576836429,0.34236247849147644,Guaviare,1433,0.8653175157013259,0.12421493370551291,0.0104675505931612
2013,95,1070,109,15,124,59478,0.18326103769460977,0.02521940885705639,1.7989844984700225,0.20848044655166617,Guaviare,1194,0.8961474036850922,0.09128978224455611,0.01256281407035176
2014,95,1128,37,14,51,63030,0.05870220529906394,0.022211645248294463,1.789623988576868,0.0809138505473584,Guaviare,1179,0.9567430025445293,0.031382527565733676,0.011874469889737066
2015,95,1162,27,22,49,67103,0.040236651118429875,0.03278541942983175,1.7316662444302042,0.07302207054826163,Guaviare,1211,0.9595375722543352,0.022295623451692816,0.018166804293971925
2016,95,1160,118,15,133,71806,0.1643316714480684,0.020889619251873104,1.61546388881152,0.1852212906999415,Guaviare,1293,0.897138437741686,0.09126063418406806,0.01160092807424594
2017,95,1258,186,14,200,77276,0.24069568818261816,0.018116879755680937,1.6279310523319013,0.2588125679382991,Guaviare,1458,0.8628257887517147,0.12757201646090535,0.009602194787379973
2008,97,700,10,24,34,16687,0.059926889195181875,0.1438245340684365,4.1948822436627315,0.2037514232636184,Vaupés,734,0.9536784741144414,0.013623978201634877,0.0326975476839237
2009,97,617,13,20,33,18305,0.07101884730947829,0.10925976509150505,3.370663753072931,0.18027861240098333,Vaupés,650,0.9492307692307692,0.02,0.03076923076923077
2010,97,627,14,11,25,20056,0.06980454726765058,0.05484642999601117,3.1262465097726366,0.12465097726366174,Vaupés,652,0.9616564417177914,0.02147239263803681,0.01687116564417178
2011,97,682,25,28,53,21097,0.11850026070057354,0.13272029198464236,3.232687111911646,0.2512205526852159,Vaupés,735,0.927891156462585,0.034013605442176874,0.0380952380952381
2012,97,696,25,16,41,23935,0.10444955086693128,0.06684771255483601,2.9078754961353668,0.1712972634217673,Vaupés,737,0.9443690637720489,0.033921302578018994,0.021709633649932156
2013,97,571,9,27,36,26116,0.03446163271557666,0.10338489814672998,2.1863991422882525,0.13784653086230664,Vaupés,607,0.9406919275123559,0.014827018121911038,0.044481054365733116
2014,97,429,18,12,30,28501,0.0631556787481141,0.042103785832076066,1.5052103434967194,0.10525946458019017,Vaupés,459,0.934640522875817,0.0392156862745098,0.026143790849673203
2015,97,618,12,12,24,31137,0.038539358319683976,0.038539358319683976,1.9847769534637247,0.07707871663936795,Vaupés,642,0.9626168224299065,0.018691588785046728,0.018691588785046728
2016,97,528,17,13,30,34110,0.049838756962767516,0.03811199061858692,1.5479331574318382,0.08795074758135445,Vaupés,558,0.946236559139785,0.03046594982078853,0.023297491039426525
2017,97,593,11,6,17,37512,0.029323949669439114,0.01599488163787588,1.5808274685433994,0.04531883130731499,Vaupés,610,0.9721311475409836,0.018032786885245903,0.009836065573770493
2008,99,837,20,24,44,50603,0.03952334841807798,0.04742801810169357,1.6540521312965635,0.08695136651977156,Vichada,881,0.9500567536889898,0.022701475595913734,0.02724177071509648
2009,99,829,27,35,62,54945,0.04914004914004914,0.0637000637000637,1.5087815087815089,0.11284011284011285,Vichada,891,0.9304152637485971,0.030303030303030304,0.03928170594837262
2010,99,835,32,31,63,59484,0.05379597875058839,0.052114854414632504,1.4037388205231658,0.1059108331652209,Vichada,898,0.9298440979955457,0.035634743875278395,0.034521158129175944
2011,99,871,57,22,79,64243,0.08872561991189702,0.03424497610634622,1.355789735846707,0.12297059601824323,Vichada,950,0.9168421052631579,0.06,0.023157894736842106
2012,99,1060,62,15,77,69260,0.08951775916835114,0.02165752237943979,1.5304649148137452,0.11117528154779094,Vichada,1137,0.9322779243623571,0.05452946350043975,0.013192612137203167
2013,99,1091,59,19,78,74571,0.07911922865457081,0.025479073634522804,1.4630352281718093,0.10459830228909361,Vichada,1169,0.9332763045337895,0.0504704875962361,0.016253207869974338
2014,99,1143,58,20,78,80213,0.07230748133095632,0.024933614252053905,1.4249560545048807,0.09724109558301024,Vichada,1221,0.9361179361179361,0.0475020475020475,0.01638001638001638
2015,99,1046,76,25,101,86283,0.08808224099764728,0.028974421380805027,1.2122897905728822,0.1170566623784523,Vichada,1147,0.911944202266783,0.06625980819529206,0.021795989537925022
2016,99,1028,104,33,137,93008,0.11181833820746602,0.03548081885429211,1.105281266127645,0.14729915706175814,Vichada,1165,0.8824034334763948,0.08927038626609442,0.02832618025751073
2017,99,1016,77,31,108,100564,0.07656815560240245,0.030826140567200986,1.0103018972992324,0.10739429616960344,Vichada,1124,0.9039145907473309,0.06850533807829182,0.027580071174377226
