year,cod_dpto,alive,fetal,no_fetal,deaths,Total,fetal_percapita,no_fetal_percapita,alive_percapita,deaths_percapita,DPNOM,Total preg,Total pregnan,prob_alive,prob_fetal,prob_no_fetal
2008,05,91137,5390,1170,6560,5783831,0.09319082801693203,0.02022880682371252,1.5757203140963143,0.11341963484064455,Antioquia,97697,97697,0.9328536188419296,0.05517057842103647,0.011975802737033891
2009,05,86022,4426,958,5384,5843258,0.07574541462998896,0.01639496322086069,1.47215816929528,0.09214037785084965,Antioquia,91406,91406,0.9410979585585192,0.04842132901560073,0.01048071242588014
2010,05,77936,4531,838,5369,5902729,0.07676110490588336,0.014196823198218994,1.3203384400672977,0.09095792810410236,Antioquia,83305,83305,0.9355500870295901,0.05439049276754097,0.010059420202868976
2011,05,75781,4994,777,5771,5959950,0.08379264926719183,0.013037022122668815,1.271503955570097,0.09682967138986065,Antioquia,81552,81552,0.9292353345104963,0.061237002158132235,0.009527663331371394
2012,05,76967,6008,737,6745,6013862,0.09990252519928126,0.012255020151776014,1.2798265074921906,0.11215754535105728,Antioquia,83712,83712,0.919426127675841,0.07176987767584098,0.008803994648318042
2013,05,74204,6130,698,6828,6066128,0.10105292865564328,0.011506516182975367,1.2232514711196334,0.11255944483861864,Antioquia,81032,81032,0.9157369927929707,0.07564912627110278,0.008613880935926547
2014,05,75907,6066,662,6728,6115769,0.09918621844611855,0.010824476856467273,1.2411685268034158,0.11001069530258582,Antioquia,82635,82635,0.9185817147697707,0.07340715193320022,0.008011133297029105
2015,05,75398,7138,636,7774,6169589,0.1156965237068466,0.010308628338127547,1.2220911311920453,0.12600515204497414,Antioquia,83172,83172,0.9065310441013803,0.08582215168566344,0.007646804212956284
2016,05,74370,7416,623,8039,6230605,0.11902535949558671,0.009999028986751687,1.1936240541648844,0.12902438848233838,Antioquia,82409,82409,0.9024499751240762,0.08999017097647102,0.007559853899452729
2017,05,76684,6052,694,6746,6296671,0.09611428006957963,0.011021697020536726,1.2178498765458763,0.10713597709011635,Antioquia,83430,83430,0.9191417955172001,0.07253985376962724,0.00831835071317272
2008,08,42210,296,748,1044,2240312,0.013212445409389406,0.033388206642646204,1.884112570034888,0.04660065205203561,Atlántico,43254,43254,0.9758635039533916,0.00684329772968974,0.017293198316918668
2009,08,40661,336,724,1060,2260455,0.014864264053033571,0.032028949923798525,1.7987971448226132,0.0468932139768321,Atlántico,41721,41721,0.9745931305577527,0.00805349823829726,0.01735337120395005
2010,08,35780,262,558,820,2285078,0.011465691761944232,0.024419297722003363,1.565810882604445,0.035884989483947596,Atlántico,36600,36600,0.9775956284153006,0.0071584699453551915,0.015245901639344262
2011,08,35629,299,610,909,2292982,0.01303978836292653,0.02660291271366282,1.553828159139496,0.03964270107658935,Atlántico,36538,36538,0.975121791012097,0.008183261262247523,0.016694947725655482
2012,08,40643,522,597,1119,2336111,0.022344828648981147,0.025555292535329014,1.7397717831044843,0.04790012118431016,Atlántico,41762,41762,0.9732053062592788,0.012499401369666204,0.014295292371055026
2013,08,39939,584,671,1255,2357801,0.02476884181489447,0.02845872064690786,1.6939088582963533,0.05322756246180233,Atlántico,41194,41194,0.9695343982133321,0.014176821867262223,0.01628877991940574
2014,08,42265,736,719,1455,2378534,0.030943429860577985,0.03022870389912442,1.776934868284414,0.0611721337597024,Atlántico,43720,43720,0.9667200365965233,0.016834400731930467,0.016445562671546204
2015,08,41761,607,693,1300,2400233,0.02528921150571632,0.028872196990875468,1.7398727540201306,0.05416140849659179,Atlántico,43061,43061,0.9698102691530619,0.01409628201853185,0.016093448828406215
2016,08,41972,1509,673,2182,2429224,0.06211860248375613,0.027704320392026426,1.7277945549689941,0.08982292287578256,Atlántico,44154,44154,0.9505820537210672,0.03417583910857454,0.015242107170358291
2017,08,43453,1748,719,2467,2464294,0.07093309483365215,0.029176713492789417,1.7633042161365486,0.10010980832644156,Atlántico,45920,45920,0.9462761324041812,0.03806620209059233,0.01565766550522648
2008,11,129047,8463,1964,10427,6936977,0.1219983863288,0.028312044280959847,1.8602771783732308,0.15031043060975985,"Bogotá, D.C.",139474,139474,0.9252405466251774,0.06067797582345097,0.014081477551371582
2009,11,126859,8043,1745,9788,7003434,0.11484366098117009,0.02491634818004996,1.811382815915735,0.13976000916122006,"Bogotá, D.C.",136647,136647,0.9283701800990874,0.05885968956508376,0.012770130335828814
2010,11,121511,9361,1626,10987,7065669,0.13248568536114555,0.023012682875464447,1.719738074342288,0.15549836823661,"Bogotá, D.C.",132498,132498,0.9170779936300926,0.07065012302072485,0.01227188334918263
2011,11,118137,9749,1550,11299,7119281,0.13693798573198615,0.021771861512419582,1.6593950990275563,0.15870984724440573,"Bogotá, D.C.",129436,129436,0.9127058932599895,0.07531907660928953,0.011975030130720973
2012,11,117678,11209,1570,12779,7162261,0.15650085915606818,0.02192045221474057,1.6430286469593889,0.17842131137080874,"Bogotá, D.C.",130457,130457,0.902044351778747,0.08592103145097618,0.012034616770276797
2013,11,116219,11417,1369,12786,7197326,0.1586283572537912,0.019020953059511268,1.6147524789067496,0.17764931031330247,"Bogotá, D.C.",129005,129005,0.9008875624975776,0.08850044571915817,0.010611991783264215
2014,11,117877,10875,1360,12235,7226652,0.15048462275476943,0.01881922638588381,1.631142609330019,0.16930384914065325,"Bogotá, D.C.",130112,130112,0.9059656296114117,0.08358183718642401,0.010452533202164289
2015,11,118077,11644,1202,12846,7253823,0.16052225150792898,0.01657057251052307,1.627789925395202,0.17709282401845206,"Bogotá, D.C.",130923,130923,0.9018812584496231,0.08893777258388519,0.009180968966491754
2016,11,114013,9943,1228,11171,7290415,0.13638455424005355,0.016844034255937418,1.5638753075099292,0.15322858849599097,"Bogotá, D.C.",125184,125184,0.9107633563394683,0.07942708333333333,0.009809560327198364
2017,11,108969,8639,1178,9817,7333415,0.11780323355489905,0.016063457475132662,1.4859243612968855,0.1338666910300317,"Bogotá, D.C.",118786,118786,0.9173555806239793,0.07272742579091812,0.009916993585102622
2008,13,29819,357,463,820,1876733,0.019022418212926398,0.024670531183711267,1.5888781195833397,0.04369294939663767,Bolívar,30639,30639,0.9732367244361761,0.011651816312542838,0.015111459251281047
2009,13,34735,543,430,973,1893035,0.028684097230109323,0.0227148467936409,1.8348841939002714,0.05139894402375022,Bolívar,35708,35708,0.9727512042119413,0.015206676375042007,0.01204211941301669
2010,13,30028,483,330,813,1916100,0.025207452638171285,0.017222483168936903,1.567141589687386,0.04242993580710819,Bolívar,30841,30841,0.9736389870626763,0.01566097078564249,0.010700042151681204
2011,13,33854,496,346,842,1933804,0.025648928226438668,0.017892195899894714,1.7506427745521262,0.04354112412633338,Bolívar,34696,34696,0.9757320728614249,0.014295596034124971,0.009972331104450081
2012,13,36150,915,436,1351,1950314,0.04691552232102113,0.022355374570453782,1.8535476851419823,0.0692708968914749,Bolívar,37501,37501,0.9639742940188262,0.024399349350683983,0.011626356630489854
2013,13,34282,1391,382,1773,1965842,0.0707584841508117,0.019431877027757064,1.7438837912711194,0.09019036117856878,Bolívar,36055,36055,0.9508251282762447,0.03857994730273194,0.010594924421023437
2014,13,34896,1128,346,1474,1971987,0.05720118844596846,0.017545754611972594,1.7695857021369816,0.07474694305794105,Bolívar,36370,36370,0.9594720923838328,0.03101457244982128,0.00951333516634589
2015,13,33901,975,338,1313,1994311,0.048889064945236725,0.0169482091810154,1.6998853238035592,0.06583727412625212,Bolívar,35214,35214,0.9627136934173908,0.027687851422729597,0.009598455159879593
2016,13,32369,1004,344,1348,2011418,0.04991503506481497,0.017102362611848953,1.60926271913645,0.06701739767666393,Bolívar,33717,33717,0.9600201678678412,0.029777263694872023,0.010202568437286829
2017,13,34906,1083,345,1428,2030869,0.05332692556733103,0.016987801773526504,1.718771619439757,0.07031472734085753,Bolívar,36334,36334,0.9606979688446083,0.02980679253591677,0.009495238619474872
2008,15,19118,256,238,494,1185966,0.021585779018960072,0.020068028931689443,1.6120192315799946,0.04165380795064951,Boyacá,19612,19612,0.9748113399959208,0.01305323271466449,0.012135427289414644
2009,15,18731,254,178,432,1170908,0.02169256679431689,0.01520187751727719,1.5996986953714554,0.03689444431159408,Boyacá,19163,19163,0.9774565569065387,0.013254709596618484,0.009288733496842875
2010,15,17736,449,180,629,1155983,0.03884140164691003,0.015571163243750125,1.534278618284179,0.05441256489066015,Boyacá,18365,18365,0.9657500680642527,0.0244486795534985,0.009801252382248844
2011,15,17217,526,159,685,1118233,0.047038497343576874,0.014218861364313162,1.5396612333923252,0.061257358707890036,Boyacá,17902,17902,0.9617361188694,0.02938219193386214,0.008881689196737794
2012,15,17207,516,137,653,1108627,0.04654405855170404,0.012357627948805143,1.5521000300371541,0.05890168650050919,Boyacá,17860,17860,0.9634378499440089,0.028891377379619262,0.007670772676371781
2013,15,16464,422,112,534,1121945,0.03761325198650558,0.009982664034333235,1.4674516130469855,0.04759591602083881,Boyacá,16998,16998,0.9685845393575715,0.024826450170608305,0.006589010471820214
2014,15,16006,387,110,497,1092867,0.03541144530853251,0.010065268692347742,1.4645880971792542,0.045476714000880256,Boyacá,16503,16503,0.9698842634672484,0.023450281766951464,0.006665454765800157
2015,15,15583,441,124,565,1031637,0.042747594357317543,0.012019731746728744,1.510511933945758,0.05476732610404629,Boyacá,16148,16148,0.9650111468912559,0.027309883576913548,0.007678969531830567
2016,15,15465,617,124,741,1035829,0.05956581636544256,0.011971087891920385,1.4930070503915223,0.07153690425736295,Boyacá,16206,16206,0.9542761940022214,0.0380723188942367,0.007651487103541898
2017,15,14921,508,86,594,1015650,0.050017230345099195,0.008467483877319944,1.46910845271501,0.05848471422241914,Boyacá,15515,15515,0.9617144698678698,0.032742507251047374,0.005543022881082823
2008,17,12754,787,153,940,940316,0.08369526839913391,0.016271125876832895,1.3563525453145537,0.0999663942759668,Caldas,13694,13694,0.9313567985979261,0.05747042500365123,0.011172776398422667
2009,17,11542,847,118,965,942490,0.08986832751541131,0.01252002673768422,1.2246283780199259,0.10238835425309552,Caldas,12507,12507,0.9228432078036299,0.06772207563764292,0.009434716558727112
2010,17,10950,695,128,823,945605,0.07349791932149259,0.013536307443382807,1.1579888008206387,0.08703422676487539,Caldas,11773,11773,0.9300942835301113,0.059033381466066424,0.010872335003822306
2011,17,10556,649,99,748,949298,0.06836630857749622,0.010428758935550269,1.1119795891279662,0.07879506751304648,Caldas,11304,11304,0.9338287331917905,0.057413305024769996,0.00875796178343949
2012,17,10396,591,104,695,953249,0.06199849147494516,0.010910056029431974,1.090585985403604,0.07290854750437714,Caldas,11091,11091,0.9373365792083671,0.05328644847173384,0.009376972319899018
2013,17,10286,588,127,715,957620,0.061402226352833066,0.013262045487771768,1.0741212589544913,0.07466427184060483,Caldas,11001,11001,0.9350059085537679,0.053449686392146166,0.011544405054085992
2014,17,10335,567,121,688,962880,0.05888584247258225,0.012566467264872051,1.0733424725822533,0.0714523097374543,Caldas,11023,11023,0.9375850494420757,0.05143790256735916,0.010977047990565182
2015,17,9940,496,116,612,969209,0.0511757525982528,0.011968522785075252,1.025578590376276,0.06314427538332805,Caldas,10552,10552,0.9420015163002274,0.04700530705079606,0.010993176648976498
2016,17,9681,363,119,482,976624,0.03716885925391963,0.012184832647979161,0.991271973656187,0.04935369190189878,Caldas,10163,10163,0.9525730591360818,0.0357177998622454,0.011709141001672734
2017,17,9298,265,75,340,984735,0.026910793259100164,0.007616262243141556,0.9442134178230691,0.03452705550224172,Caldas,9638,9638,0.9647229715708653,0.027495330981531438,0.007781697447603237
2008,18,7268,120,179,299,330358,0.03632423007767331,0.054183643199196024,2.200037535037747,0.09050787327686934,Caquetá,7567,7567,0.9604863221884499,0.015858332232060263,0.02365534557948989
2009,18,7451,77,117,194,336689,0.022869770025156746,0.034750170038225184,2.2130215124343238,0.05761994006338193,Caquetá,7645,7645,0.9746239372138653,0.010071942446043165,0.015304120340091563
2010,18,7305,94,92,186,343162,0.02739231033739167,0.026809495223830145,2.12873220228347,0.05420180556122181,Caquetá,7491,7491,0.9751702042450942,0.012548391403016954,0.012281404351888934
2011,18,7537,68,91,159,349751,0.019442403309783245,0.026018510311621695,2.1549616727328873,0.04546091362140494,Caquetá,7696,7696,0.9793399168399168,0.008835758835758836,0.011824324324324325
2012,18,7839,73,75,148,356438,0.020480420157222293,0.02104152755879003,2.1992604604447337,0.04152194771601232,Caquetá,7987,7987,0.9814698885689245,0.009139852259922374,0.009390259171153124
2013,18,7741,61,74,135,363283,0.016791316962258076,0.020369794347657337,2.130845649259668,0.03716111130991541,Caquetá,7876,7876,0.9828593194514982,0.007745048247841544,0.009395632300660234
2014,18,7591,243,49,292,370412,0.06560262626480784,0.01322851311512586,2.0493396542228655,0.07883113937993369,Caquetá,7883,7883,0.9629582646200685,0.030825827730559432,0.006215907649372066
2015,18,7359,405,48,453,377925,0.10716411986505259,0.012700932724746974,1.9472117483627704,0.11986505258979957,Caquetá,7812,7812,0.9420122887864824,0.05184331797235023,0.006144393241167435
2016,18,6932,578,54,632,385914,0.14977430204656997,0.013992754862482314,1.7962551241986557,0.16376705690905227,Caquetá,7564,7564,0.9164463246959281,0.07641459545214173,0.007139079851930196
2017,18,7223,453,56,509,394539,0.11481754655433303,0.014193780589498124,1.8307442356775883,0.12901132714383115,Caquetá,7732,7732,0.9341696844283497,0.05858768753233316,0.007242628039317123
2008,19,15597,318,209,527,1268319,0.025072556667526072,0.01647850422488349,1.2297379444761136,0.04155106089240956,Cauca,16124,16124,0.9673158025303895,0.01972215331183329,0.012962044157777226
2009,19,15618,238,233,471,1287169,0.01849019048780696,0.018101741107811018,1.2133604833553324,0.03659193159561798,Cauca,16089,16089,0.9707253402946112,0.014792715519920443,0.014481944185468332
2010,19,15346,291,199,490,1305905,0.022283397337478607,0.015238474467897742,1.1751237647455213,0.03752187180537635,Cauca,15836,15836,0.9690578428896186,0.018375852488002022,0.012566304622379388
2011,19,15175,378,180,558,1304380,0.028979285177632284,0.013799659608396327,1.1633879697634124,0.04277894478602861,Cauca,15733,15733,0.9645331468887053,0.02402593275281256,0.011440920358482171
2012,19,15832,662,215,877,1342625,0.049306396052509076,0.01601340657294479,1.1791825714551718,0.06531980262545387,Cauca,16709,16709,0.9475133161769106,0.039619366808306904,0.012867317014782453
2013,19,16096,926,160,1086,1360715,0.06805245771524529,0.011758524011273485,1.1829075155341127,0.07981098172651878,Cauca,17182,17182,0.9367943196368292,0.0538936095914329,0.009312070771737865
2014,19,15626,1071,147,1218,1379169,0.07765545774303222,0.010658592239239716,1.133001104288162,0.08831404998227194,Cauca,16844,16844,0.9276893849441937,0.06358347185941582,0.008727143196390405
2015,19,15669,1053,169,1222,1398252,0.0753083135228843,0.012086519454290071,1.120613451652492,0.08739483297717436,Cauca,16891,16891,0.9276537801195903,0.06234089159907643,0.010005328281333254
2016,19,15712,1003,141,1144,1418047,0.07073108296128408,0.00994325293872488,1.108002767186137,0.08067433590000896,Cauca,16856,16856,0.9321309919316564,0.05950403417180826,0.008364973896535358
2017,19,15991,945,145,1090,1438502,0.0656933393210437,0.010079930372011995,1.1116425281299573,0.07577326969305569,Cauca,17081,17081,0.9361864059481295,0.05532462970552075,0.008488964346349746
2008,20,21307,464,363,827,966278,0.048019307073119744,0.03756682859384152,2.2050589995839704,0.08558613566696127,Cesar,22134,22134,0.9626366675702539,0.02096322399927713,0.016400108430468963
2009,20,20981,517,331,848,984735,0.05250143439605579,0.033613104033064736,2.1306239749780396,0.08611453842912052,Cesar,21829,21829,0.9611525951715608,0.02368408997205552,0.01516331485638371
2010,20,18873,765,264,1029,1003449,0.07623705838562797,0.026309259364452005,1.8808130757019041,0.10254631775007997,Cesar,19902,19902,0.948296653602653,0.038438347904733196,0.013264998492613807
2011,20,20655,216,239,455,1022255,0.021129757252348974,0.02337968510792317,2.0205330372558707,0.04450944236027214,Cesar,21110,21110,0.9784462340123165,0.010232117479867362,0.0113216485078162
2012,20,20492,253,285,538,1041453,0.024292982976668175,0.027365613234586677,1.9676356014145622,0.051658596211254855,Cesar,21030,21030,0.9744174988112221,0.012030432715168807,0.01355206847360913
2013,20,20567,272,270,542,1061257,0.025629984066065054,0.025441528300873397,1.937984861348382,0.05107151236693845,Cesar,21109,21109,0.9743237481642901,0.012885499076223411,0.012790752759486474
2014,20,21464,249,286,535,1081319,0.023027432237850254,0.026449179196888245,1.9849831548322003,0.0494766114347385,Cesar,21999,21999,0.9756807127596709,0.011318696304377472,0.013000590935951635
2015,20,20872,268,260,528,1102461,0.024309249941721293,0.023583600689729613,1.8932188984462943,0.047892850631450906,Cesar,21400,21400,0.9753271028037384,0.012523364485981308,0.012149532710280374
2016,20,20540,479,306,785,1127772,0.04247312400024118,0.02713314393334823,1.8212901189247472,0.06960626793358941,Cesar,21325,21325,0.9631887456037515,0.022461899179366942,0.014349355216881594
2017,20,20118,325,284,609,1156930,0.028091587217895637,0.02454772544579188,1.738912466614229,0.052639312663687515,Cesar,20727,20727,0.9706180344478217,0.015680030877599265,0.013701934674579051
2008,23,26729,2020,528,2548,1585428,0.1274103901280916,0.0333033098948675,1.685916988977109,0.1607137000229591,Córdoba,29277,29277,0.9129692249888991,0.06899614031492297,0.018034634696177887
2009,23,26380,1667,579,2246,1565312,0.10649634066563088,0.03698943086106795,1.6852870226510752,0.14348577152669884,Córdoba,28626,28626,0.9215398588695591,0.05823377349262908,0.02022636763781178
2010,23,24181,1980,417,2397,1628693,0.12156987228409528,0.02560335189013522,1.4846874150008627,0.1471732241742305,Córdoba,26578,26578,0.9098126269847242,0.07449770486868838,0.015689668146587402
2011,23,28774,2749,488,3237,1649069,0.16670011988582648,0.02959245489424639,1.7448633137849296,0.19629257478007286,Córdoba,32011,32011,0.8988785105120115,0.08587672987410577,0.015244759613882728
2012,23,29087,2829,497,3326,1668439,0.16955969022541428,0.02978832309721842,1.7433661044844913,0.19934801332263272,Córdoba,32413,32413,0.8973868509548638,0.08727979514392373,0.015333353901212477
2013,23,28123,2717,493,3210,1686682,0.16108549210817452,0.029228983293827764,1.6673563837166698,0.19031447540200228,Córdoba,31333,31333,0.8975521016181023,0.08671368844349409,0.0157342099384036
2014,23,28048,2862,503,3365,1703629,0.1679943227075848,0.029525207659648903,1.6463678418247165,0.19751953036723371,Córdoba,31413,31413,0.8928787444688505,0.09110877662114411,0.01601247891000541
2015,23,26753,2433,521,2954,1719347,0.14150721174957703,0.030302201940620478,1.5559977130852585,0.1718094136901975,Córdoba,29707,29707,0.9005621570673579,0.08189988891507052,0.017537954017571616
2016,23,26385,2829,476,3305,1700080,0.16640393393252081,0.02799868241494518,1.5519857889040516,0.194402616347466,Córdoba,29690,29690,0.8886830582687774,0.09528460761199056,0.016032334119232064
2017,23,27000,3070,445,3515,1730939,0.1773603806951025,0.02570858938414352,1.5598469963412922,0.20306897007924601,Córdoba,30515,30515,0.8848107488120597,0.10060625921677864,0.014582991971161724
2008,25,26946,1967,307,2274,2344067,0.08391398368732635,0.013096895267925361,1.1495405208127583,0.0970108789552517,Cundinamarca,29220,29220,0.92217659137577,0.06731690622861054,0.01050650239561944
2009,25,25967,2074,276,2350,2337554,0.08872522303228075,0.011807213865433697,1.1108620378395537,0.10053243689771445,Cundinamarca,28317,28317,0.9170109828018504,0.07324222198679238,0.009746795211357136
2010,25,24974,2109,239,2348,2369789,0.08899526497928718,0.010085286073992242,1.0538490979576662,0.09908055105327943,Cundinamarca,27322,27322,0.9140619281165361,0.07719054242002782,0.008747529463436059
2011,25,23878,1982,273,2255,2342682,0.08460388563193809,0.011653310180382997,1.019259122663682,0.09625719581232109,Cundinamarca,26133,26133,0.91371063406421,0.07584280411739945,0.010446561818390541
2012,25,23228,2321,271,2592,2338184,0.09926507067022955,0.011590191362185354,0.9934205349108539,0.1108552620324149,Cundinamarca,25820,25820,0.8996127033307514,0.08989155693261038,0.010495739736638265
2013,25,22460,2267,230,2497,2403651,0.0943148568573391,0.009568776831578295,0.9344118592923848,0.1038836336889174,Cundinamarca,24957,24957,0.8999479104058982,0.09083623832992747,0.00921585126417438
2014,25,22265,2097,196,2293,2431736,0.08623468994989587,0.008060085469804287,0.9156010356387371,0.09429477541970016,Cundinamarca,24558,24558,0.9066292043326004,0.08538968971414611,0.007981105953253522
2015,25,22081,1961,213,2174,2462507,0.07963429139490771,0.00864972160485229,0.8966878063696875,0.08828401299976,Cundinamarca,24255,24255,0.9103689960832818,0.080849309420738,0.00878169449598021
2016,25,21589,1828,224,2052,2538412,0.07201352656700331,0.00882441463403104,0.8504923550629291,0.08083794120103435,Cundinamarca,23641,23641,0.9132016412165306,0.07732329427689184,0.009475064506577556
2017,25,20462,1494,188,1682,2627324,0.05686394217081715,0.007155569697532546,0.7788152508027179,0.0640195118683497,Cundinamarca,22144,22144,0.9240426300578035,0.06746748554913294,0.008489884393063583
2008,27,5113,94,153,247,435933,0.02156294659959214,0.03509713648657018,1.1728866591884533,0.05666008308616232,Chocó,5360,5360,0.9539179104477612,0.01753731343283582,0.028544776119402985
2009,27,5090,93,171,264,447513,0.020781519196090392,0.0382111804573275,1.1373971258935494,0.05899269965341789,Chocó,5354,5354,0.9506910720956294,0.017370190511766904,0.03193873739260366
2010,27,5165,114,142,256,458775,0.02484878208272029,0.03095199171707264,1.1258242057653534,0.055800773799792924,Chocó,5421,5421,0.9527762405460247,0.021029330381848368,0.026194429072126914
2011,27,5587,69,102,171,469671,0.014691134858230549,0.02171732979042777,1.1895560935207836,0.036408464648658316,Chocó,5758,5758,0.9703021882598124,0.01198332754428621,0.017714484195901353
2012,27,5549,52,120,172,480181,0.010829249803719847,0.024990576470122726,1.1556059069392584,0.03581982627384257,Chocó,5721,5721,0.9699353259919594,0.009089320048942492,0.02097535395909806
2013,27,5969,101,100,201,490310,0.020599212742958537,0.020395260141543105,1.2173930778487079,0.04099447288450164,Chocó,6170,6170,0.9674230145867099,0.016369529983792545,0.01620745542949757
2014,27,6338,129,112,241,489500,0.026353421859039838,0.022880490296220635,1.2947906026557712,0.04923391215526047,Chocó,6579,6579,0.9633682930536556,0.0196078431372549,0.017023863809089528
2015,27,5905,153,136,289,509545,0.03002678860552061,0.026690478760462766,1.1588770373568575,0.05671726736598338,Chocó,6194,6194,0.9533419438165968,0.024701323861801745,0.02195673232160155
2016,27,5051,103,122,225,518731,0.019856148948106053,0.023518933705523673,0.9737224110377055,0.04337508265362972,Chocó,5276,5276,0.9573540561031084,0.019522365428354813,0.02312357846853677
2017,27,5304,110,100,210,527700,0.020845177184006063,0.01895016107636915,1.0051165434906197,0.039795338260375214,Chocó,5514,5514,0.9619151251360174,0.01994922016684802,0.018135654697134566
2008,41,20960,1944,315,2259,1043622,0.18627434070956725,0.030183342244605806,2.008390010942659,0.21645768295417306,Huila,23219,23219,0.9027089883285241,0.08372453594039364,0.013566475731082304
2009,41,20205,1717,275,1992,1050376,0.1634652733878154,0.026181100862929085,1.9235968834017534,0.1896463742507445,Huila,22197,22197,0.9102581429922962,0.07735279542280489,0.01238906158489886
2010,41,19154,2066,231,2297,1057179,0.19542575098445958,0.021850604296907147,1.8118029207920323,0.21727635528136674,Huila,21451,21451,0.892918745046851,0.09631252622255372,0.01076872873059531
2011,41,20494,2690,211,2901,1063845,0.2528563841537066,0.019833716377855796,1.9264084523591312,0.2726901005315624,Huila,23395,23395,0.8759991451164779,0.11498183372515494,0.009019021158367172
2012,41,21391,2503,246,2749,1066290,0.23473914225961043,0.023070646822159074,2.006114659239044,0.2578097890817695,Huila,24140,24140,0.886122618061309,0.10368682684341342,0.010190555095277548
2013,41,21192,2864,208,3072,1067996,0.2681657983737767,0.01947572837351451,1.9842770946707666,0.2876415267472912,Huila,24264,24264,0.8733926805143423,0.11803494889548302,0.008572370590174745
2014,41,20679,2742,229,2971,1073413,0.2554468783217643,0.021333820253714088,1.9264719171465223,0.2767806985754784,Huila,23650,23650,0.8743763213530655,0.11594080338266385,0.009682875264270613
2015,41,20085,2583,197,2780,1082626,0.23858654789373246,0.01819649629696682,1.8552113102770487,0.2567830441906993,Huila,22865,22865,0.8784167942269845,0.11296741745025148,0.008615788322764049
2016,41,20087,2769,225,2994,1082623,0.25576770491667,0.020782857929306876,1.8554011876710546,0.27655056284597684,Huila,23081,23081,0.870282916684719,0.11996880551102639,0.009748277804254581
2017,41,20355,2632,206,2838,1085548,0.2424581870170642,0.018976590625195754,1.8750898163876677,0.2614347776422599,Huila,23193,23193,0.8776354934678566,0.11348251627646272,0.008881990255680594
2008,44,12639,146,185,331,628905,0.023214952973819574,0.029416207535319323,2.009683497507573,0.0526311605091389,La Guajira,12970,12970,0.9744795682343871,0.01125674633770239,0.014263685427910563
2009,44,12559,149,219,368,649933,0.02292544000689302,0.033695780949728665,1.932353027158184,0.056621220956621685,La Guajira,12927,12927,0.9715324514581883,0.011526262860679199,0.016941285681132512
2010,44,12173,150,205,355,670808,0.02236109289096135,0.030560160284313843,1.8146772250778167,0.05292125317527519,La Guajira,12528,12528,0.9716634738186463,0.011973180076628353,0.016363346104725417
2011,44,12586,290,231,521,691488,0.041938544125133044,0.03340621963070943,1.8201328150307743,0.07534476375584247,La Guajira,13107,13107,0.9602502479591059,0.022125581750209813,0.017624170290684367
2012,44,13283,202,246,448,712422,0.028353981207767307,0.03453009592629088,1.8644848137761045,0.06288407713405818,La Guajira,13731,13731,0.9673730973709125,0.014711237346151046,0.01791566528293642
2013,44,13209,142,218,360,733953,0.019347287905356336,0.02970217438991325,1.7997065207172667,0.04904946229526959,La Guajira,13569,13569,0.9734689365465399,0.01046503058442037,0.016066032869039723
2014,44,14675,144,224,368,755815,0.019052281312225874,0.02963688204124025,1.9416126962285745,0.048689163353466125,La Guajira,15043,15043,0.9755367945223692,0.009572558665159875,0.014890646812470917
2015,44,15135,185,207,392,778983,0.02374891364766625,0.026573108784145483,1.9429178813915067,0.05032202243181173,La Guajira,15527,15527,0.9747536549236814,0.011914729181425903,0.013331615894892767
2016,44,15925,208,259,467,795944,0.02613249173308675,0.032539977686872446,2.0007688983144543,0.05867246941995919,La Guajira,16392,16392,0.9715104929233772,0.01268911664226452,0.015800390434358224
2017,44,17583,221,240,461,839302,0.026331403952331817,0.028595189812487043,2.094955093637332,0.054926593764818864,La Guajira,18044,18044,0.9744513411660386,0.012247838616714697,0.01330082021724673
2008,47,22424,226,434,660,1205692,0.01874442229026982,0.03599592599104912,1.8598448028186303,0.05474034828131894,Magdalena,23084,23084,0.9714087679778202,0.009790330965170681,0.018800901057009184
2009,47,22792,224,406,630,1219122,0.01837387890629486,0.03330265551765943,1.8695421787155018,0.05167653442395429,Magdalena,23422,23422,0.9731022115959355,0.009563658099222952,0.017334130304841603
2010,47,21203,180,333,513,1231539,0.014615858693878148,0.027039338583674574,1.7216669549238799,0.04165519727755272,Magdalena,21716,21716,0.9763768649843434,0.008288819303739179,0.015334315711917481
2011,47,22903,321,331,652,1242844,0.02582785932908716,0.02663246553871604,1.8427896019130316,0.0524603248678032,Magdalena,23555,23555,0.9723201018891955,0.013627679898110805,0.014052218212693696
2012,47,23758,588,296,884,1253378,0.046913221709651835,0.023616179636151265,1.8955175533637898,0.0705294013458031,Magdalena,24642,24642,0.9641262884506128,0.023861699537375214,0.012012012012012012
2013,47,22773,810,286,1096,1263418,0.06411179831219754,0.0226370053299858,1.802491336992191,0.08674880364218335,Magdalena,23869,23869,0.9540827014118731,0.03393522979596967,0.01198206879215719
2014,47,22770,944,266,1210,1272648,0.07417604867960348,0.020901301852515385,1.7891828691044185,0.09507735053211885,Magdalena,23980,23980,0.9495412844036697,0.039366138448707254,0.011092577147623019
2015,47,22114,948,237,1185,1281842,0.07395607258928948,0.01848901814732237,1.7251736173412948,0.09244509073661185,Magdalena,23299,23299,0.9491394480449805,0.040688441564015625,0.010172110391003906
2016,47,22202,993,212,1205,1293944,0.07674211557841762,0.016384016618957234,1.7158393253494741,0.09312613219737485,Magdalena,23407,23407,0.9485196736019139,0.04242320673302858,0.009057119665057461
2017,47,24162,1131,241,1372,1308191,0.08645526532440599,0.018422386333494117,1.8469780024476548,0.10487765165790011,Magdalena,25534,25534,0.9462677214694133,0.044293882666248924,0.009438395864337746
2008,50,16131,760,252,1012,812684,0.09351728347057404,0.031008362413927185,1.9849043416629342,0.12452564588450123,Meta,17143,17143,0.9409671586070116,0.044332963891967565,0.014699877501020826
2009,50,16024,1555,256,1811,836720,0.1858447270293527,0.030595659240845206,1.9150970456066545,0.2164403862701979,Meta,17835,17835,0.8984580880291562,0.08718811326044294,0.014353798710400897
2010,50,15685,1825,202,2027,860497,0.21208673592121763,0.023474805838951212,1.8227838098215334,0.23556154176016883,Meta,17712,17712,0.8855578139114725,0.10303748870822041,0.011404697380307137
2011,50,15855,2359,220,2579,883858,0.2668980763878361,0.024890876136211926,1.793840186998364,0.29178895252404796,Meta,18434,18434,0.860095475751329,0.1279700553325377,0.011934468916133232
2012,50,16362,2580,197,2777,906690,0.28455150051285444,0.021727382015904004,1.8045859113919862,0.30627888252875846,Meta,19139,19139,0.8549035999791003,0.13480328125816396,0.010293118762735774
2013,50,16123,2225,205,2430,929042,0.23949401641691118,0.02206574083841204,1.7354436075010602,0.2615597572553232,Meta,18553,18553,0.8690238775400205,0.11992669649113351,0.011049425968846009
2014,50,16464,2297,207,2504,951062,0.24151948032830667,0.021765142545911834,1.7311174245212195,0.2632846228742185,Meta,18968,18968,0.8679881906368621,0.12109869253479545,0.010913116828342471
2015,50,16462,2197,162,2359,972890,0.22582203537912818,0.01665141999609411,1.6920720739240818,0.24247345537522227,Meta,18821,18821,0.8746612826098507,0.1167313107698847,0.008607406620264598
2016,50,15473,2030,198,2228,994750,0.20407137471726564,0.01990449861774315,1.5554661975370696,0.2239758733350088,Meta,17701,17701,0.8741314050053669,0.11468278628326083,0.011185808711372239
2017,50,15860,1708,167,1875,1016553,0.16801878505104997,0.016428066219862616,1.5601744326168925,0.1844468512709126,Meta,17735,17735,0.8942768536791655,0.09630673808852551,0.009416408232308994
2008,52,21045,522,322,844,1560792,0.033444558916242526,0.020630551668640022,1.348353912628973,0.05407511058488255,Nariño,21889,21889,0.9614418200922838,0.023847594682260498,0.014710585225455708
2009,52,20565,792,313,1105,1565524,0.050590089963488266,0.019993305755772506,1.3136176768928487,0.07058339571926077,Nariño,21670,21670,0.9490078449469312,0.03654822335025381,0.014443931702814952
2010,52,18891,1218,264,1482,1584807,0.07685478421031709,0.016658179828837202,1.1920063452521348,0.0935129640391543,Nariño,20373,20373,0.9272566632307466,0.05978500957149168,0.012958327197761743
2011,52,18479,1599,289,1888,1594919,0.10025587506324772,0.01812004245983652,1.1586168325789585,0.11837591752308424,Nariño,20367,20367,0.9073010261697845,0.0785093533657387,0.01418962046447685
2012,52,17855,1726,236,1962,1603360,0.1076489372318132,0.014719089911186508,1.1135989422213353,0.1223680271429997,Nariño,19817,19817,0.9009940959782006,0.08709693697330574,0.011908967048493717
2013,52,17785,1760,230,1990,1601897,0.10986973569461707,0.014357976823728366,1.1102461643913435,0.12422771251834544,Nariño,19775,19775,0.8993678887484198,0.08900126422250317,0.011630847029077117
2014,52,18683,2368,220,2588,1615776,0.14655496801536846,0.01361574871764403,1.1562865149624701,0.1601707167330125,Nariño,21271,21271,0.8783320013163461,0.11132527854825819,0.01034272013539561
2015,52,18265,2356,227,2583,1584715,0.14867026563135957,0.014324342231883967,1.1525731756183288,0.16299460786324355,Nariño,20848,20848,0.8761032233307752,0.11300844205679202,0.010888334612432847
2016,52,18172,2144,189,2333,1615994,0.13267375992732647,0.011695587978668237,1.1245091256526942,0.1443693479059947,Nariño,20505,20505,0.8862228724701292,0.10455986344793952,0.009217264081931235
2017,52,18528,1962,191,2153,1609690,0.12188682292863844,0.011865638725468879,1.1510290801334417,0.1337524616541073,Nariño,20681,20681,0.8958947826507422,0.09486968715245878,0.009235530196798994
2008,54,21686,269,375,644,1303351,0.020639106426434628,0.02877198851268768,1.6638649143630533,0.04941109493912231,Norte de Santander,22330,22330,0.9711598746081505,0.012046574115539633,0.016793551276309895
2009,54,21873,269,259,528,1318403,0.020403472989670077,0.01964497956997974,1.6590526568886752,0.04004845255964982,Norte de Santander,22401,22401,0.9764296236775144,0.012008392482478461,0.011561983840007143
2010,54,20297,305,238,543,1332538,0.022888653081563154,0.017860653880039445,1.5231835790048764,0.040749306961602595,Norte de Santander,20840,20840,0.9739443378119002,0.01463531669865643,0.011420345489443378
2011,54,21252,325,244,569,1345383,0.024156689953715782,0.018136099534482003,1.5796245381426701,0.042292789488197785,Norte de Santander,21821,21821,0.9739242014573117,0.014893909536684844,0.011181889006003391
2012,54,20885,304,220,524,1357528,0.02239364491929448,0.01620592724422627,1.538458138616662,0.03859957216352075,Norte de Santander,21409,21409,0.9755243122051473,0.014199635667242748,0.010276052127609884
2013,54,20099,272,180,452,1369326,0.019863787001780438,0.013145153162942937,1.467802407899945,0.033008940164723374,Norte de Santander,20551,20551,0.9780059364507809,0.013235365675636221,0.008758697873582794
2014,54,20384,428,186,614,1371507,0.031206548708829048,0.01356172443888365,1.486248338506475,0.0447682731477127,Norte de Santander,20998,20998,0.9707591199161825,0.020382893608915136,0.008857986474902371
2015,54,20430,537,199,736,1386515,0.03873019765382993,0.01435253134657757,1.4734784693998983,0.053082729000407496,Norte de Santander,21166,21166,0.9652272512520079,0.025370877822923556,0.009401870925068506
2016,54,20409,1684,212,1896,1397108,0.120534704546821,0.015174202710169865,1.4608033165653622,0.13570890725699086,Norte de Santander,22305,22305,0.9149966375252185,0.07549876709258013,0.0095045953822013
2017,54,21114,2375,197,2572,1422106,0.16700583500807956,0.013852694524880705,1.4846994527834072,0.18085852953296028,Norte de Santander,23686,23686,0.891412648822089,0.10027020180697459,0.008317149370936418
2008,63,6853,554,85,639,550322,0.10066833599238265,0.015445502814715748,1.2452709504617296,0.11611383880709839,Quindio,7492,7492,0.9147090229578216,0.07394554191137213,0.011345435130806193
2009,63,6691,625,99,724,550951,0.1134402151915506,0.017968930086341615,1.2144455677546642,0.13140914527789221,Quindio,7415,7415,0.90236008091706,0.08428860418071477,0.01335131490222522
2010,63,6321,755,72,827,551570,0.13688199140634916,0.013053646862592238,1.1460014141450767,0.14993563826894138,Quindio,7148,7148,0.8843033016228316,0.10562395075545607,0.010072747621712367
2011,63,6268,792,66,858,551815,0.1435263630020931,0.011960530250174425,1.135887933455959,0.15548689325226753,Quindio,7126,7126,0.879595846197025,0.11114229581813079,0.009261857984844232
2012,63,6216,649,60,709,551306,0.11772046739923019,0.01088324814168538,1.1275045074786054,0.12860371554091557,Quindio,6925,6925,0.8976173285198557,0.09371841155234657,0.008664259927797834
2013,63,6089,532,54,586,547067,0.09724585836835342,0.009870820210321587,1.1130263751971878,0.107116678578675,Quindio,6675,6675,0.9122097378277153,0.0797003745318352,0.008089887640449439
2014,63,6053,460,57,517,545721,0.08429215661482699,0.010444897667489432,1.1091748347598864,0.09473705428231642,Quindio,6570,6570,0.9213089802130898,0.0700152207001522,0.008675799086757991
2015,63,6207,431,69,500,547423,0.07873253407328519,0.012604512415444729,1.1338580951110933,0.09133704648872992,Quindio,6707,6707,0.9254510213210079,0.0642612196212912,0.010287759057700909
2016,63,6120,367,57,424,545719,0.06725072793873771,0.010444935946888417,1.1214562806132826,0.07769566388562611,Quindio,6544,6544,0.9352078239608802,0.056081907090464546,0.008710268948655257
2017,63,6163,374,66,440,540007,0.0692583614656847,0.012222063788062006,1.1412815019064568,0.08148042525374671,Quindio,6603,6603,0.9333636225957898,0.05664092079357868,0.009995456610631531
2008,66,13077,664,163,827,926053,0.0717021595956171,0.01760158435856263,1.412122200349224,0.08930374395417973,Risaralda,13904,13904,0.9405207134637514,0.047756041426927506,0.01172324510932106
2009,66,12481,437,165,602,931434,0.046916904472029154,0.017714620681658605,1.3399768528956426,0.06463152515368775,Risaralda,13083,13083,0.9539860888175495,0.03340212489490178,0.012611786287548728
2010,66,11995,449,145,594,936744,0.047931985686591,0.015479149052462572,1.2804992612709556,0.06341113473905358,Risaralda,12589,12589,0.9528159504329177,0.035666057669393916,0.011517991897688458
2011,66,12279,1187,135,1322,941267,0.12610662011947726,0.014342370443242991,1.3045182716487458,0.14044899056272026,Risaralda,13601,13601,0.9028012646128961,0.0872729946327476,0.009925740754356297
2012,66,12194,1204,143,1347,944167,0.12751981376176036,0.015145625720873532,1.2915088114708522,0.1426654394826339,Risaralda,13541,13541,0.9005243335056495,0.08891514659183221,0.010560519902518278
2013,66,11690,1119,129,1248,945518,0.11834782627089066,0.01364331509289088,1.2363593289604218,0.13199114136378154,Risaralda,12938,12938,0.9035399598083166,0.0864894110372546,0.009970629154428815
2014,66,11531,1103,110,1213,946424,0.11654395915572724,0.01162269764925657,1.21837569630525,0.12816665680498382,Risaralda,12744,12744,0.9048179535467671,0.08655053358443189,0.008631512868801004
2015,66,11550,1029,117,1146,947125,0.10864458228850468,0.01235317407945097,1.2194800052791341,0.12099775636795565,Risaralda,12696,12696,0.9097353497164461,0.08104914933837429,0.009215500945179584
2016,66,11331,928,127,1055,946730,0.0980216112302346,0.01341459550241357,1.1968565483295133,0.11143620673264817,Risaralda,12386,12386,0.9148231874697239,0.07492330050056516,0.010253512029710964
2017,66,11037,755,127,882,944007,0.07997822050048357,0.01345329007094227,1.1691650591574003,0.09343151057142585,Risaralda,11919,11919,0.926000503397936,0.06334424028861482,0.010655256313449116
2008,68,33349,491,419,910,2029500,0.024193151022419316,0.02064547918206455,1.6432126139443213,0.044838630204483865,Santander,34259,34259,0.9734376368253598,0.014332000350272921,0.012230362824367319
2009,68,30949,405,397,802,2029174,0.019958860107610287,0.0195646110190649,1.5252018801739033,0.03952347112667519,Santander,31751,31751,0.9747409530408491,0.012755503763660987,0.012503543195489906
2010,68,30362,516,391,907,2035143,0.02535448368984391,0.019212409152575518,1.4918853368043425,0.04456689284241943,Santander,31269,31269,0.9709936358693914,0.016501966804183057,0.012504397326425533
2011,68,31577,792,342,1134,2013019,0.039343890941913616,0.01698940745218997,1.5686389447888966,0.05633329839410358,Santander,32711,32711,0.9653327626792211,0.024212038763718628,0.010455198557060317
2012,68,31916,872,356,1228,2081487,0.04189312736519613,0.017103157502304844,1.5333268956279813,0.05899628486750098,Santander,33144,33144,0.9629495534636736,0.026309437605599808,0.010741008930726527
2013,68,31239,806,379,1185,2083059,0.03869309510676366,0.018194395838043952,1.4996694764766625,0.05688749094480761,Santander,32424,32424,0.9634529977794226,0.024858129780409573,0.011688872440167777
2014,68,31745,832,385,1217,2093344,0.03974502040753933,0.01839162602993106,1.5164731644679517,0.05813664643747038,Santander,32962,32962,0.9630786966810266,0.025241186821188033,0.01168011649778533
2015,68,31686,1224,307,1531,2096769,0.058375529207080036,0.014641574727592787,1.5111822046205377,0.07301710393467283,Santander,33217,33217,0.9539091429087515,0.03684860161965259,0.00924225547159587
2016,68,30573,1354,311,1665,2103830,0.06435881226144698,0.014782563229918767,1.453206770509024,0.07914137549136575,Santander,32238,32238,0.9483528754885538,0.042000124077176,0.009647000434270116
2017,68,30776,1387,250,1637,2124268,0.06529307978089394,0.011768759873989534,1.4487814155276075,0.07706183965488347,Santander,32413,32413,0.9494955727640144,0.04279147255730725,0.007712954678678308
2008,70,16217,792,184,976,817004,0.09693954986756491,0.022521309565191848,1.9849352022756315,0.11946085943275675,Sucre,17193,17193,0.9432327109870297,0.046065259117082535,0.01070202989588786
2009,70,15895,865,150,1015,824591,0.10490049006113333,0.01819083642678613,1.9276223000251034,0.12309132648791947,Sucre,16910,16910,0.9399763453577764,0.0511531638083974,0.008870490833826138
2010,70,14379,847,117,964,832054,0.10179627764544129,0.014061587348898029,1.728133029827391,0.11585786499433931,Sucre,15343,15343,0.9371700449716484,0.055204327706445934,0.007625627321905755
2011,70,15432,666,112,778,839333,0.07934872094865804,0.013343929048422973,1.8386027953148512,0.09269264999708102,Sucre,16210,16210,0.9520049352251696,0.04108574953732264,0.0069093152375077115
2012,70,15414,822,145,967,846534,0.09710182934176301,0.017128668192890068,1.8208364932772931,0.11423049753465307,Sucre,16381,16381,0.9409681948598987,0.05018008668579452,0.00885171845430682
2013,70,14723,1038,131,1169,853740,0.12158268325251248,0.015344250005856585,1.7245297163070723,0.13692693325836905,Sucre,15892,15892,0.926440976591996,0.06531588220488296,0.008243141203121068
2014,70,15505,1081,188,1269,860831,0.12557633263671963,0.021839362197690372,1.8011665472084533,0.14741569483441,Sucre,16774,16774,0.9243472040062001,0.06444497436508882,0.0112078216287111
2015,70,15362,932,171,1103,868140,0.10735595641256018,0.019697283848227245,1.7695302600962979,0.12705324026078743,Sucre,16465,16465,0.9330094139082903,0.05660491952626784,0.010385666565441846
2016,70,15324,724,139,863,876886,0.08256489441044788,0.01585154740753074,1.747547571748209,0.09841644181797862,Sucre,16187,16187,0.9466856119107926,0.044727250262556376,0.008587137826651017
2017,70,16542,797,180,977,886784,0.08987532476905312,0.020298065819861433,1.8653922488452657,0.11017339058891455,Sucre,17519,17519,0.9442319767109995,0.045493464238826414,0.010274559050174097
2008,73,20770,1842,260,2102,1340435,0.13741807696755157,0.019396688388470907,1.5494969916482335,0.15681476535602248,Tolima,22872,22872,0.9080972367960826,0.08053515215110178,0.01136761105281567
2009,73,19816,1757,216,1973,1338765,0.13124035958514005,0.01613427300534448,1.4801701568236396,0.1473746325904845,Tolima,21789,21789,0.909449722336959,0.08063701867915003,0.009913258983890954
2010,73,18508,1464,219,1683,1337101,0.10949060691750287,0.016378717838069077,1.3841886289816552,0.12586932475557194,Tolima,20191,20191,0.9166460304095885,0.07250755287009064,0.010846416720320936
2011,73,18234,1348,197,1545,1335351,0.10094724158666897,0.014752675513778775,1.3654836818184881,0.11569991710044775,Tolima,19779,19779,0.9218868496890642,0.06815309166287477,0.009960058648061074
2012,73,18373,1496,200,1696,1333435,0.11219144540228808,0.014998856337204288,1.377869937417272,0.12719030173949236,Tolima,20069,20069,0.9154915541382231,0.0745428272460013,0.009965618615775574
2013,73,17519,1131,157,1288,1331462,0.08494421921166356,0.011791549439638532,1.3157716855606845,0.09673576865130211,Tolima,18807,18807,0.9315148614877439,0.06013718296379008,0.008347955548465997
2014,73,16748,1118,154,1272,1329675,0.08408069641077708,0.01158177750202117,1.2595559065185102,0.09566247391279824,Tolima,18020,18020,0.9294117647058824,0.06204217536071032,0.008546059933407325
2015,73,16675,1262,123,1385,1328196,0.09501609702182509,0.00926068140545522,1.255462296227364,0.10427677842728031,Tolima,18060,18060,0.9233111849390919,0.0698781838316722,0.00681063122923588
2016,73,16155,1067,135,1202,1327052,0.08040378221802913,0.010172924648016807,1.2173599828793447,0.09057670686604594,Tolima,17357,17357,0.9307484012214092,0.0614737569856542,0.007777841792936568
2017,73,16391,862,118,980,1325839,0.06501543550913799,0.008900024814475965,1.2362737858819963,0.07391546032361396,Tolima,17371,17371,0.9435841344770018,0.04962293477635139,0.00679293074664671
2008,76,61883,1911,885,2796,4185557,0.04565700574618862,0.021144139238815765,1.47848900397247,0.06680114498500439,Valle del Cauca,64679,64679,0.956771131279086,0.029545911346804992,0.013682957374109062
2009,76,60125,1615,773,2388,4213124,0.038332600701996906,0.0183474305527205,1.4270883078684606,0.0566800312547174,Valle del Cauca,62513,62513,0.9617999456113129,0.025834626397709278,0.012365427990977876
2010,76,55961,1355,729,2084,4242544,0.03193838413932772,0.01718308637459034,1.3190434795726338,0.04912147051391806,Valle del Cauca,58045,58045,0.9640968214316479,0.023343957274528385,0.012559221293823758
2011,76,57312,1441,688,2129,4271578,0.033734605806097884,0.016106459954611622,1.3417055711027635,0.049841065760709506,Valle del Cauca,59441,59441,0.9641829713497417,0.024242526202452853,0.011574502447805387
2012,76,57199,2747,687,3434,4297442,0.06392174693689874,0.015986254148398046,1.3310010932084715,0.07990800108529679,Valle del Cauca,60633,60633,0.9433641746243795,0.0453053617666947,0.011330463608925832
2013,76,53951,4818,620,5438,4320101,0.11152517036060036,0.014351516318715696,1.248836543404888,0.12587668667931606,Valle del Cauca,59389,59389,0.9084342218255906,0.08112613446934618,0.010439643705063227
2014,76,55437,5953,615,6568,4343720,0.13704842853590932,0.014158371165728914,1.276256296446364,0.15120679970163822,Valle del Cauca,62005,62005,0.8940730586243045,0.09600838642044997,0.009918554955245545
2015,76,53478,5897,617,6514,4369781,0.13494955468020023,0.014119700735574621,1.2238141911459637,0.14906925541577484,Valle del Cauca,59992,59992,0.8914188558474463,0.09829643952527004,0.010284704627283639
2016,76,52272,4829,576,5405,4395220,0.10986935807536369,0.013105146045021637,1.1892920035857135,0.12297450412038533,Valle del Cauca,57677,57677,0.9062884685403194,0.08372488166860273,0.0099866497910779
2017,76,53322,3639,611,4250,4415765,0.0824092767617842,0.01383678705728226,1.2075370858730028,0.09624606381906646,Valle del Cauca,57572,57572,0.9261793927603696,0.06320780935176822,0.010612797887862156
2008,81,4867,464,35,499,154394,0.30052981333471507,0.022669274712747906,3.1523245721984017,0.323199088047463,Arauca,5366,5366,0.9070070816250466,0.08647036898993664,0.006522549385016773
2009,81,4723,665,29,694,159983,0.4156691648487652,0.018126925985886,2.9521886700461923,0.4337960908346512,Arauca,5417,5417,0.8718848070887946,0.12276167620454126,0.0053535167066642055
2010,81,4522,664,34,698,166179,0.3995691393015965,0.02045986556664801,2.721162120364186,0.42002900486824446,Arauca,5220,5220,0.8662835249042146,0.12720306513409962,0.006513409961685823
2011,81,4445,647,25,672,172963,0.3740684423836312,0.014453958361036754,2.569913796592335,0.38852240074466793,Arauca,5117,5117,0.8686730506155951,0.12644127418409223,0.004885675200312683
2012,81,4483,647,25,672,180519,0.3584110259861843,0.013848957727441432,2.4833950996847975,0.37225998371362573,Arauca,5155,5155,0.8696411251212415,0.12550921435499515,0.004849660523763337
2013,81,4015,673,15,688,188999,0.356086540140424,0.007936549928835602,2.124349864284996,0.36402309006925965,Arauca,4703,4703,0.8537103976185414,0.1431001488411652,0.00318945354029343
2014,81,4005,619,19,638,198319,0.3121233971530716,0.009580524306798642,2.0194736762488716,0.3217039214598702,Arauca,4643,4643,0.8625888434202025,0.13331897480077537,0.004092181779022184
2015,81,4285,684,23,707,208981,0.3273024820438222,0.011005785214923845,2.050425636780377,0.338308267258746,Arauca,4992,4992,0.8583733974358975,0.13701923076923078,0.004607371794871795
2016,81,4410,667,23,690,222543,0.29971735799373606,0.010335081310128828,1.9816395033768754,0.3100524393038649,Arauca,5100,5100,0.8647058823529412,0.1307843137254902,0.0045098039215686276
2017,81,4647,658,25,683,239211,0.2750709624557399,0.010451024409412611,1.942636417221616,0.2855219868651525,Arauca,5330,5330,0.8718574108818011,0.12345215759849906,0.004690431519699813
2008,85,6198,52,40,92,323102,0.01609398889514766,0.012379991457805894,1.9182796763870233,0.028473980352953558,Casanare,6290,6290,0.9853736089030206,0.008267090620031796,0.006359300476947536
2009,85,5073,50,30,80,332286,0.015047278549201591,0.009028367129520955,1.5266968816019935,0.024075645678722547,Casanare,5153,5153,0.9844750630700563,0.009703085581214826,0.005821851348728896
2010,85,6220,102,35,137,341508,0.02986752872553498,0.010248661817585533,1.821333614439486,0.04011619054312051,Casanare,6357,6357,0.9784489539090766,0.01604530438886267,0.00550574170206072
2011,85,6151,196,26,222,350718,0.05588535518564773,0.007413363442994087,1.7538307129944857,0.06329871862864181,Casanare,6373,6373,0.9651655421308646,0.0307547465871646,0.0040797112819708145
2012,85,6762,206,23,229,359951,0.05723001186272576,0.006389758606032488,1.8785890301735515,0.06361977046875825,Casanare,6991,6991,0.967243598912888,0.029466456873122587,0.003289944213989415
2013,85,6565,93,14,107,369271,0.025184755910970535,0.0037912535779955642,1.77782712425292,0.028976009488966097,Casanare,6672,6672,0.9839628297362111,0.01393884892086331,0.0020983213429256594
2014,85,6458,30,23,53,378685,0.007922151656389875,0.006073649603232238,1.7053751798988606,0.013995801259622114,Casanare,6511,6511,0.9918599293503302,0.004607587160190447,0.003532483489479343
2015,85,6454,63,37,100,388353,0.01622235440436922,0.009527414491454939,1.6618900845364912,0.02574976889582416,Casanare,6554,6554,0.9847421422032346,0.00961245041196216,0.0056454073848031736
2016,85,5972,49,32,81,398751,0.01228837043668856,0.00802505824436804,1.4976764948551853,0.020313428681056598,Casanare,6053,6053,0.9866182058483397,0.008095159425078473,0.00528663472658186
2017,85,6042,133,22,155,409927,0.032444801147521386,0.005366809212371959,1.4739209664159716,0.03781161035989335,Casanare,6197,6197,0.974987897369695,0.021461997740842342,0.0035501048894626434
2008,86,4429,63,31,94,269216,0.023401283727564483,0.011514917389753953,1.6451473909425889,0.034916201117318434,Putumayo,4523,4523,0.9792173336281229,0.01392880831306655,0.006853858058810524
2009,86,4441,53,36,89,277228,0.019117838025019117,0.012985701300012985,1.601930540926602,0.032103539325032106,Putumayo,4530,4530,0.9803532008830023,0.011699779249448124,0.007947019867549669
2010,86,3834,71,37,108,285225,0.02489262862652292,0.012972214918047155,1.3442019458322376,0.03786484354457008,Putumayo,3942,3942,0.9726027397260274,0.018011161846778284,0.009386098427194317
2011,86,4014,111,39,150,293029,0.037880209808585495,0.01330926290571923,1.3698302898347945,0.051189472714304726,Putumayo,4164,4164,0.9639769452449568,0.026657060518731988,0.009365994236311239
2012,86,4011,91,25,116,300518,0.03028104805702154,0.00831896924643449,1.3346954258979495,0.03860001730345603,Putumayo,4127,4127,0.9718924157984008,0.022049915192633874,0.00605766900896535
2013,86,4108,242,28,270,307845,0.07861098929656159,0.009095486364891422,1.33443778524907,0.08770647566145301,Putumayo,4378,4378,0.9383280036546369,0.05527638190954774,0.006395614435815441
2014,86,3999,389,27,416,308680,0.12602047427756902,0.008746922379162888,1.2955163923804587,0.1347673966567319,Putumayo,4415,4415,0.9057757644394111,0.08810872027180068,0.006115515288788222
2015,86,4113,494,18,512,316476,0.15609398500992178,0.005687635081333181,1.299624616084632,0.16178162009125494,Putumayo,4625,4625,0.8892972972972973,0.10681081081081081,0.0038918918918918917
2016,86,3825,665,19,684,308644,0.21545858659167197,0.006155959616904913,1.2392918702453313,0.22161454620857687,Putumayo,4509,4509,0.8483033932135728,0.14748281215347084,0.00421379463295631
2017,86,4195,689,17,706,332774,0.20704742558012346,0.005108572184124961,1.2606153124943655,0.2121559977642484,Putumayo,4901,4901,0.8559477657620894,0.14058355437665782,0.0034686798612528057
2008,88,812,253,10,263,58813,0.4301770016833013,0.017003043544794517,1.380647135837315,0.44718004522809585,"Archipiélago de San Andrés, Providencia y Santa Catalina",1075,1075,0.7553488372093023,0.23534883720930233,0.009302325581395349
2009,88,881,256,9,265,59121,0.43301026707937956,0.015223017202009439,1.490164239441146,0.44823328428138903,"Archipiélago de San Andrés, Providencia y Santa Catalina",1146,1146,0.768760907504363,0.22338568935427575,0.007853403141361256
2010,88,823,172,12,184,59429,0.28942098975247776,0.02019216207575426,1.3848457823621465,0.309613151828232,"Archipiélago de San Andrés, Providencia y Santa Catalina",1007,1007,0.817279046673287,0.1708043694141013,0.011916583912611719
2011,88,847,143,6,149,59732,0.23940266523806336,0.010044867072925736,1.418000401794683,0.2494475323109891,"Archipiélago de San Andrés, Providencia y Santa Catalina",996,996,0.8504016064257028,0.14357429718875503,0.006024096385542169
2012,88,802,148,15,163,60026,0.24655982407623364,0.024989171359077734,1.3360876953320229,0.27154899543531136,"Archipiélago de San Andrés, Providencia y Santa Catalina",965,965,0.8310880829015544,0.1533678756476684,0.015544041450777202
2013,88,865,191,10,201,60300,0.3167495854063018,0.01658374792703151,1.4344941956882256,0.3333333333333333,"Archipiélago de San Andrés, Providencia y Santa Catalina",1066,1066,0.8114446529080676,0.17917448405253283,0.009380863039399626
2014,88,849,187,16,203,60583,0.3086674479639503,0.0264100490236535,1.4013832263176138,0.3350774969876038,"Archipiélago de San Andrés, Providencia y Santa Catalina",1052,1052,0.8070342205323194,0.17775665399239543,0.015209125475285171
2015,88,806,231,17,248,60896,0.3793352601156069,0.027916447714135574,1.3235680504466631,0.4072517078297425,"Archipiélago de San Andrés, Providencia y Santa Catalina",1054,1054,0.7647058823529411,0.21916508538899432,0.016129032258064516
2016,88,848,226,9,235,61202,0.36926897813796933,0.014705401784255416,1.385575634783177,0.3839743799222248,"Archipiélago de San Andrés, Providencia y Santa Catalina",1083,1083,0.7830101569713758,0.20867959372114497,0.008310249307479225
2017,88,804,192,15,207,61504,0.31217481789802287,0.02438865764828304,1.3072320499479708,0.33656347554630595,"Archipiélago de San Andrés, Providencia y Santa Catalina",1011,1011,0.7952522255192879,0.18991097922848665,0.01483679525222552
2008,91,1475,16,32,48,52098,0.030711351683365966,0.06142270336673193,2.8312027333103,0.09213405505009789,Amazonas,1523,1523,0.9684832567301379,0.010505581089954037,0.021011162179908074
2009,91,1336,11,30,41,52794,0.020835701026631813,0.05682463916354131,2.530590597416373,0.07766034019017312,Amazonas,1377,1377,0.9702251270878722,0.007988380537400145,0.02178649237472767
2010,91,1313,28,27,55,55880,0.05010737294201861,0.048317823908375086,2.3496778811739443,0.0984251968503937,Amazonas,1368,1368,0.9597953216374269,0.02046783625730994,0.019736842105263157
2011,91,1420,19,17,36,57010,0.033327486405893704,0.02981932994211542,2.490791089282582,0.06314681634800912,Amazonas,1456,1456,0.9752747252747253,0.01304945054945055,0.011675824175824176
2012,91,1603,28,23,51,60318,0.04642063728903478,0.038131237773135714,2.6575814847972414,0.08455187506217049,Amazonas,1654,1654,0.9691656590084643,0.016928657799274487,0.013905683192261185
2013,91,1420,21,29,50,63091,0.03328525463219793,0.045965351634940005,2.2507172179867174,0.07925060626713794,Amazonas,1470,1470,0.9659863945578231,0.014285714285714285,0.019727891156462583
2014,91,1550,22,22,44,64879,0.03390927726999492,0.03390927726999492,2.3890627167496414,0.06781855453998983,Amazonas,1594,1594,0.972396486825596,0.013801756587202008,0.013801756587202008
2015,91,1491,21,17,38,67310,0.031198930322388945,0.025256276927648195,2.2151240528896152,0.056455207250037144,Amazonas,1529,1529,0.9751471550032701,0.013734466971877043,0.011118378024852845
2016,91,1340,11,11,22,69917,0.015732940486576943,0.015732940486576943,1.9165582047284637,0.031465880973153885,Amazonas,1362,1362,0.9838472834067548,0.008076358296622614,0.008076358296622614
2017,91,1433,20,13,33,72713,0.027505397934344616,0.017878508657324,1.9707617619957918,0.04538390659166861,Amazonas,1466,1466,0.9774897680763983,0.013642564802182811,0.008867667121418827
2008,94,559,40,14,54,21622,0.18499676255665526,0.06474886689482934,2.5853297567292572,0.2497456294514846,Guainía,613,613,0.9119086460032626,0.06525285481239804,0.022838499184339316
2009,94,564,68,14,82,21756,0.3125574554145983,0.06435006435006435,2.592388306674021,0.37690751976466264,Guainía,646,646,0.8730650154798761,0.10526315789473684,0.021671826625386997
2010,94,547,53,15,68,24792,0.2137786382704098,0.060503388189738626,2.206356889319135,0.27428202646014843,Guainía,615,615,0.8894308943089431,0.08617886178861789,0.024390243902439025
2011,94,595,81,13,94,26993,0.3000777979476161,0.04816063423850628,2.2042751824547104,0.3482384321861223,Guainía,689,689,0.8635703918722787,0.11756168359941944,0.018867924528301886
2012,94,480,52,8,60,26434,0.19671635015510328,0.03026405387001589,1.8158432322009532,0.22698040402511915,Guainía,540,540,0.8888888888888888,0.0962962962962963,0.014814814814814815
2013,94,584,62,9,71,28668,0.21626901074368635,0.031393888656341566,2.0371145528114973,0.24766289940002792,Guainía,655,655,0.8916030534351145,0.09465648854961832,0.013740458015267175
2014,94,587,60,8,68,31061,0.19316828176813367,0.025755770902417822,1.8898296899649079,0.21892405267055148,Guainía,655,655,0.8961832061068702,0.0916030534351145,0.012213740458015267
2015,94,576,25,12,37,32646,0.07657906022177295,0.03675794890645102,1.764381547509649,0.11333700912822398,Guainía,613,613,0.9396411092985318,0.040783034257748776,0.01957585644371941
2016,94,660,15,22,37,35216,0.04259427532939573,0.06247160381644707,1.874148114493412,0.1050658791458428,Guainía,697,697,0.9469153515064562,0.021520803443328552,0.03156384505021521
2017,94,834,12,13,25,43505,0.027583036432593955,0.029881622801976784,1.9170210320652799,0.05746465923457074,Guainía,859,859,0.9708963911525029,0.013969732246798603,0.015133876600698487
2008,95,1610,17,13,30,47524,0.035771399713828804,0.0273545997811632,3.3877619728979043,0.06312599949499201,Guaviare,1640,1640,0.9817073170731707,0.010365853658536586,0.007926829268292683
2009,95,1451,10,8,18,49255,0.020302507359658918,0.016242005887727135,2.945893817886509,0.03654451324738605,Guaviare,1469,1469,0.9877467665078284,0.0068073519400953025,0.005445881552076242
2010,95,1335,8,9,17,51297,0.01559545392518081,0.01754488566582841,2.6024913737645474,0.03314033959100922,Guaviare,1352,1352,0.9874260355029586,0.005917159763313609,0.006656804733727811
2011,95,1271,78,11,89,53662,0.14535425440721553,0.02049867690358168,2.368528940404756,0.1658529313107972,Guaviare,1360,1360,0.9345588235294118,0.057352941176470586,0.008088235294117648
2012,95,1203,163,5,168,56373,0.2891455129228531,0.008869494261437212,2.1340003193017933,0.29801500718429036,Guaviare,1371,1371,0.8774617067833698,0.11889132020423049,0.0036469730123997084
2013,95,1040,98,7,105,59478,0.16476680453276843,0.011769057466626315,1.7485456807559097,0.17653586199939472,Guaviare,1145,1145,0.9082969432314411,0.08558951965065502,0.00611353711790393
2014,95,1135,33,6,39,63030,0.05235602094240838,0.00951927653498334,1.8007298112010155,0.06187529747739172,Guaviare,1174,1174,0.9667802385008518,0.028109028960817718,0.005110732538330494
2015,95,1194,20,11,31,67103,0.029804926754392502,0.016392709714915875,1.7793541272372324,0.04619763646930838,Guaviare,1225,1225,0.9746938775510204,0.0163265306122449,0.008979591836734694
2016,95,1178,135,6,141,71806,0.18800657326685793,0.008355847700749241,1.6405314319137676,0.19636242096760717,Guaviare,1319,1319,0.8931008339651251,0.1023502653525398,0.004548900682335102
2017,95,1279,193,10,203,77276,0.2497541280604586,0.012940628396914955,1.6551063719654227,0.26269475645737356,Guaviare,1482,1482,0.8630229419703104,0.13022941970310392,0.006747638326585695
2008,97,678,10,18,28,16687,0.059926889195181875,0.10786840055132738,4.063043087433331,0.16779528974650926,Vaupés,706,706,0.9603399433427762,0.014164305949008499,0.025495750708215296
2009,97,575,13,17,30,18305,0.07101884730947829,0.0928708003277793,3.1412182463807703,0.16388964763725758,Vaupés,605,605,0.9504132231404959,0.021487603305785124,0.02809917355371901
2010,97,607,13,10,23,20056,0.0648185081771041,0.0498603909054647,3.0265257279617073,0.11467889908256881,Vaupés,630,630,0.9634920634920635,0.020634920634920634,0.015873015873015872
2011,97,651,19,26,45,21097,0.09006019813243589,0.12324027112859648,3.085746788642935,0.21330046926103238,Vaupés,696,696,0.9353448275862069,0.027298850574712645,0.03735632183908046
2012,97,719,21,13,34,23935,0.08773762272822228,0.05431376645080426,3.0039690829329433,0.14205138917902654,Vaupés,753,753,0.9548472775564409,0.027888446215139442,0.017264276228419653
2013,97,600,8,17,25,26116,0.030632562413845918,0.06509419512942258,2.297442181038444,0.0957267575432685,Vaupés,625,625,0.96,0.0128,0.0272
2014,97,404,16,7,23,28501,0.056138381109434754,0.024560541735377705,1.4174941230132276,0.08069892284481246,Vaupés,427,427,0.9461358313817331,0.03747072599531616,0.01639344262295082
2015,97,607,9,8,17,31137,0.028904518739762984,0.025692905546455983,1.9494492083373478,0.05459742428621897,Vaupés,624,624,0.9727564102564102,0.014423076923076924,0.01282051282051282
2016,97,509,13,8,21,34110,0.03811199061858692,0.023453532688361183,1.4922310172969804,0.06156552330694811,Vaupés,530,530,0.960377358490566,0.024528301886792454,0.01509433962264151
2017,97,576,7,2,9,37512,0.018660695244188525,0.0053316272126252935,1.5355086372360844,0.02399232245681382,Vaupés,585,585,0.9846153846153847,0.011965811965811967,0.003418803418803419
2008,99,746,14,13,27,50603,0.027666343892654585,0.025690176471750686,1.4742208959943086,0.053356520364405274,Vichada,773,773,0.9650711513583441,0.018111254851228976,0.016817593790426907
2009,99,719,18,19,37,54945,0.03276003276003276,0.03458003458003458,1.3085813085813085,0.06734006734006734,Vichada,756,756,0.951058201058201,0.023809523809523808,0.02513227513227513
2010,99,712,13,17,30,59484,0.021854616367426534,0.028579113711250083,1.1969605272005917,0.05043373007867662,Vichada,742,742,0.9595687331536388,0.01752021563342318,0.022911051212938006
2011,99,646,14,9,23,64243,0.02179225752222032,0.014009308407141634,1.005557025668166,0.035801565929361956,Vichada,669,669,0.9656203288490284,0.02092675635276532,0.013452914798206279
2012,99,858,15,7,22,69260,0.02165752237943979,0.010106843777071902,1.2388102801039562,0.031764366156511695,Vichada,880,880,0.975,0.017045454545454544,0.007954545454545454
2013,99,894,13,6,19,74571,0.017433050381515602,0.008046023253007201,1.198857464698073,0.025479073634522804,Vichada,913,913,0.9791894852135816,0.014238773274917854,0.0065717415115005475
2014,99,858,14,9,23,80213,0.017453529976437735,0.011220126413424259,1.0696520514131125,0.028673656389861992,Vichada,881,881,0.9738933030646992,0.015891032917139614,0.01021566401816118
2015,99,724,32,12,44,86283,0.03708725936743043,0.013907722262786412,0.8390992431881136,0.050994981630216846,Vichada,768,768,0.9427083333333334,0.041666666666666664,0.015625
2016,99,657,69,16,85,93008,0.07418716669533804,0.01720282126268708,0.7063908480990883,0.09138998795802511,Vichada,742,742,0.8854447439353099,0.09299191374663072,0.0215633423180593
2017,99,732,49,18,67,100564,0.04872518992880156,0.017899049361600573,0.7278946740384233,0.06662423929040213,Vichada,799,799,0.9161451814768461,0.06132665832290363,0.02252816020025031
